ID	Gene Name	Species	GAD_DISEASE
PDPK1	3-phosphoinositide dependent protein kinase 1(PDPK1)	Homo sapiens	Adenocarcinoma, Papillary|thyroid neoplasm|Thyroid Neoplasms,plasma HDL cholesterol (HDL-C) levels,
NT5C	5', 3'-nucleotidase, cytosolic(NT5C)	Homo sapiens	Acquired Immunodeficiency Syndrome|Disease Progression,pyrimidine 5' nucleotidase-I deficiency,
PHYKPL	5-phosphohydroxy-L-lysine phospho-lyase(PHYKPL)	Homo sapiens	Acquired Immunodeficiency Syndrome|Disease Progression,
AKAP13	A-kinase anchoring protein 13(AKAP13)	Homo sapiens	Graft vs Host Disease,Tobacco Use Disorder,breast cancer,coronary spastic angina,smoking cessation,
ACD	ACD shelterin complex subunit and telomerase recruitment factor(ACD)	Homo sapiens	Cardiovascular Diseases|Cerebrovascular Disorders,breast cancer   ,glucocorticoid deficiency triple A syndrome,
ADAM8	ADAM metallopeptidase domain 8(ADAM8)	Homo sapiens	Alzheimer's disease   ,Asthma|Hypersensitivity,atherosclerosis,ovarian cancer,
ARF1	ADP ribosylation factor 1(ARF1)	Homo sapiens	Alzheimer's disease   ,HIV Infections|[X]Human immunodeficiency virus disease,Occupational Diseases,
AAK1	AP2 associated kinase 1(AAK1)	Homo sapiens	Parkinson Disease,Parkinson's disease    ,Parkinson's disease (age of onset),Tobacco Use Disorder,
ABCF1	ATP binding cassette subfamily F member 1(ABCF1)	Homo sapiens	Graves Disease,Lupus Erythematosus, Systemic,ankylosing spondylitis,drug-related genes ,
ABCF2	ATP binding cassette subfamily F member 2(ABCF2)	Homo sapiens	Acquired Immunodeficiency Syndrome|Disease Progression,drug-related genes ,
ACLY	ATP citrate lyase(ACLY)	Homo sapiens	Acquired Immunodeficiency Syndrome|Disease Progression,longevity,plasma HDL cholesterol (HDL-C) levels,schizophrenia,
ATP6V0C	ATPase H+ transporting V0 subunit c(ATP6V0C)	Homo sapiens	Autism,
ATP6V1B2	ATPase H+ transporting V1 subunit B2(ATP6V1B2)	Homo sapiens	Depressive Disorder, Major,Hemoglobins,Mental Disorders,Tobacco Use Disorder,major depressive disorder (broad),
ATP2B1	ATPase plasma membrane Ca2+ transporting 1(ATP2B1)	Homo sapiens	Biomedical quantitative traits,Blood Pressure,Diastolic blood pressure,Hypertension,Type 2 Diabetes| edema | rosiglitazone,hypertension,normal variation,systolic blood pressure,
ATP2B4	ATPase plasma membrane Ca2+ transporting 4(ATP2B4)	Homo sapiens	Hemoglobins,Hypertension,Iron,Tobacco Use Disorder,
ATRX	ATRX chromatin remodeler(ATRX)	Homo sapiens	breast cancer   ,
AHI1	Abelson helper integration site 1(AHI1)	Homo sapiens	Autism,Joubert syndrome nephronophthisis,Multiple Sclerosis,Schizophrenia,Tobacco Use Disorder,Type 2 diabetes,schizophrenia,
ARAP2	ArfGAP with RhoGAP domain, ankyrin repeat and PH domain 2(ARAP2)	Homo sapiens	Hemoglobin A, Glycosylated,response to TNF antagonist treatment,von Willebrand Factor,
ACAP1	ArfGAP with coiled-coil, ankyrin repeat and PH domains 1(ACAP1)	Homo sapiens	Tobacco Use Disorder,longevity,
BDP1	B double prime 1, subunit of RNA polymerase III transcription initiation factor IIIB(BDP1)	Homo sapiens	Tobacco Use Disorder,
BAG1	BAG cochaperone 1(BAG1)	Homo sapiens	Head and Neck Neoplasms|Neoplasm Recurrence, Local|Neoplasms, Second Primary,Lymphoma, Non-Hodgkin|Lymphoma, Non-Hodgkin's,Type 2 Diabetes| edema | rosiglitazone,narcolepsy,
BBX	BBX high mobility group box domain containing(BBX)	Homo sapiens	Arteries,Body Fat Distribution,Body Mass Index,Body Weight,Celiac Disease|,Cholesterol,Insulin,Insulin Resistance,Smoking,Waist Circumference,Waist-Hip Ratio,smoking behavior,
BID	BH3 interacting domain death agonist(BID)	Homo sapiens	Acquired Immunodeficiency Syndrome|Disease Progression,Adenocarcinoma|Lymphatic Metastasis|Stomach Neoplasms,Chronic renal failure|Kidney Failure, Chronic,Hepatitis C, Chronic|HIV Infections|Liver Diseases,Leukemia, Lymphocytic, Chronic, B-Cell,Lymphoma, Non-Hodgkin|Lymphoma, Non-Hodgkin's,Tobacco Use Disorder,Type 2 Diabetes| edema | rosiglitazone,breast cancer   ,clubfoot,colorectal cancer,diabetes, type 1 ,esophageal adenocarcinoma,
BORCS5	BLOC-1 related complex subunit 5(BORCS5)	Homo sapiens	Breath Tests,Magnesium,
BCCIP	BRCA2 and CDKN1A interacting protein(BCCIP)	Homo sapiens	Carcinoma, Basal Cell|Carcinoma, Squamous Cell|Coronary Artery Disease|Melanoma|Skin Neoplasms,Coronary Artery Disease,Waist Circumference,breast cancer   ,prostate cancer,
BRK1	BRICK1 subunit of SCAR/WAVE actin nucleating complex(BRK1)	Homo sapiens	Adrenal Gland Neoplasms|Carcinoma, Renal Cell|Cerebellar Neoplasms|Hemangioblastoma|Kidney Neoplasms|Pheochromocytoma|Retinal Neoplasms|von Hippel-Lindau Disease,
BTG3	BTG anti-proliferation factor 3(BTG3)	Homo sapiens	Cholesterol, HDL,Lipids,Respiratory Function Tests,
BANP	BTG3 associated nuclear protein(BANP)	Homo sapiens	Cornea,Fibrinogen,Menopause,Stroke,Tobacco Use Disorder,
BUD31	BUD31 homolog(BUD31)	Homo sapiens	Blood Pressure,
CCR7	C-C motif chemokine receptor 7(CCR7)	Homo sapiens	Birth Weight|Leukemia|Leukemia, Myeloid, Acute|Precursor Cell Lymphoblastic Leukemia-Lymphoma,Diabetes Mellitus, Type 1,HIV,Leukemia, Lymphocytic, Chronic, B-Cell,Meningeal Neoplasms|meningioma,breast cancer   ,lupus erythematosus sclerosis, systemic Sjogren's syndrome,
CXCR4	C-X-C motif chemokine receptor 4(CXCR4)	Homo sapiens	Body Height,Breath Tests,Carcinoma, Hepatocellular|Liver Neoplasms,Carcinoma, Squamous Cell|Lymphatic Metastasis|Mouth Neoplasms,Celiac Disease|,Coronary Disease,Electrocardiography,HIV,HIV Infected Long- Term Nonprogressors,HIV Infections,HIV Infections|[X]Human immunodeficiency virus disease,HIV infection,HIV/SIV infection,Leukemia, Lymphocytic, Chronic, B-Cell,Lymphoma, Non-Hodgkin,Multiple Sclerosis,Neuroblastoma,Telomere,Type 2 Diabetes| edema | rosiglitazone,Type 2 diabetes,asthma,asthma; HIV disease progression,breast cancer   ,cirrhosis hepatitis B, chronic,colorectal cancer,diabetes, type 2,multiple sclerosis,thyroid cancer,
CXCR6	C-X-C motif chemokine receptor 6(CXCR6)	Homo sapiens	Acquired Immunodeficiency Syndrome,HIV,HIV; pneumocystis carinii pneumonia,monocyte chemoattractant protein 1 (66-77),ovarian cancer,
CMC1	C-X9-C motif containing 1(CMC1)	Homo sapiens	Acquired Immunodeficiency Syndrome|Disease Progression,Body Mass Index,
CMC2	C-X9-C motif containing 2(CMC2)	Homo sapiens	high-density lipoprotein cholesterol ,smoking cessation,
CFLAR	CASP8 and FADD like apoptosis regulator(CFLAR)	Homo sapiens	Asthma|Bronchial Hyperreactivity,Hepatitis C, Chronic|HIV Infections|Liver Diseases,Hodgkin Disease|Leukemia, Lymphocytic, Chronic, B-Cell|Lymphoproliferative Disorders|Waldenstrom Macroglobulinemia,Lymphoma, Follicular,Multiple Myeloma,Type 2 Diabetes| edema | rosiglitazone,benzene haematotoxicity,breast cancer cervical cancer colorectal cancer esophageal cancer lung cancer stomach cancer,esophageal adenocarcinoma,lung cancer,multiple sclerosis,ovarian cancer,
CNOT1	CCR4-NOT transcription complex subunit 1(CNOT1)	Homo sapiens	Electrocardiography,QT interval,
CNOT6L	CCR4-NOT transcription complex subunit 6 like(CNOT6L)	Homo sapiens	Asthma,Cholesterol,Cholesterol, LDL,Tobacco Use Disorder,
CD164	CD164 molecule(CD164)	Homo sapiens	height,mean corpuscular volume,
CD2	CD2 molecule(CD2)	Homo sapiens	Arthritis, Rheumatoid|,Waist-Hip Ratio,
CD247	CD247 molecule(CD247)	Homo sapiens	Arthritis, Rheumatoid,Arthritis, Rheumatoid|,Autoimmune Diseases,Celiac Disease,Celiac disease,Hypertension,Lupus Erythematosus, Systemic,Lupus Erythematosus, Systemic|Systemic lupus erythematosus,Osteoporosis,Scleroderma, Systemic,Scleroderma, Systemic|Systemic Scleroderma,Sclerosis,
CD27	CD27 molecule(CD27)	Homo sapiens	Asthma|Bronchial Hyperreactivity,Chronic renal failure|Kidney Failure, Chronic,Multiple Myeloma,benzene haematotoxicity,longevity,
CD3D	CD3 delta subunit of T-cell receptor complex(CD3D)	Homo sapiens	Celiac Disease,Rhinitis, Allergic, Seasonal,
CD3E	CD3 epsilon subunit of T-cell receptor complex(CD3E)	Homo sapiens	CD3 epsilon locus on chromosome 11,Celiac Disease,Heart Failure,Type 2 Diabetes| edema | rosiglitazone,bronchodilator response,depression,diabetes, type 1,
CD3G	CD3 gamma subunit of T-cell receptor complex(CD3G)	Homo sapiens	Arthritis, Rheumatoid|,Celiac Disease,
CD37	CD37 molecule(CD37)	Homo sapiens	Type 2 Diabetes| edema | rosiglitazone,
CD48	CD48 molecule(CD48)	Homo sapiens	Type 2 Diabetes| edema | rosiglitazone,diabetes, type 1,esophageal adenocarcinoma,schizophrenia,
CD5	CD5 molecule(CD5)	Homo sapiens	Chronic Lymphocytic Leukemia|Leukemia, Lymphocytic, Chronic, B-Cell|Lymphoma|Syndrome,DNA Damage|Leukemia, Lymphocytic, Chronic, B-Cell,Hodgkin Disease|Leukemia, Lymphocytic, Chronic, B-Cell|Lymphoproliferative Disorders|Waldenstrom Macroglobulinemia,Multiple Myeloma,benzene haematotoxicity,leukemia,
CD59	CD59 molecule (CD59 blood group)(CD59)	Homo sapiens	Lymphoma, Non-Hodgkin,Macular Degeneration,
CD69	CD69 molecule(CD69)	Homo sapiens	Addison Disease|,Arthritis, Rheumatoid|,Diabetes Mellitus, Insulin-Dependent|Diabetes Mellitus, Type 1,Diabetes Mellitus, Type 1,Forced Vital Capacity,diabetes, type 1 ,type 1 diabetes,
CD74	CD74 molecule(CD74)	Homo sapiens	Celiac Disease,Heart Failure,Type 2 Diabetes| edema | rosiglitazone,
CD96	CD96 molecule(CD96)	Homo sapiens	Abnormalities, Multiple|Congenital Abnormalities|Craniofacial Abnormalities|Syndrome|Translocation, Genetic,Body Height,Glomerular Filtration Rate,
CDC42EP3	CDC42 effector protein 3(CDC42EP3)	Homo sapiens	Alzheimer Disease,Body Height,Bone Density,Conduct Disorder,Coronary Artery Disease,Diabetes Mellitus,Prostatic Neoplasms,Respiratory Function Tests,
CISD2	CDGSH iron sulfur domain 2(CISD2)	Homo sapiens	Diabetes Mellitus,
CLPTM1	CLPTM1 regulator of GABA type A receptor forward trafficking(CLPTM1)	Homo sapiens	Cleft Lip|Cleft Palate,Type 2 Diabetes| edema | rosiglitazone,benzene haematotoxicity,cleft lip with cleft palate; cleft lip without cleft palate,cleft lip with cleft palate; cleft lip without cleft palate; cleft palate,oral clefts,
CREBBP	CREB binding protein(CREBBP)	Homo sapiens	Alzheimer's disease   ,Body Weights and Measures,Dengue Hemorrhagic Fever,Femur Head Necrosis|,Huntington disease-like,Rubinstein-Taybi syndrome,Spinal Dysraphism,antipsychotic response | Weight Gain,breast cancer   ,bronchodilator response,depression,osteonecrosis, steroid induced,plasma HDL cholesterol (HDL-C) levels,
CTR9	CTR9 homolog, Paf1/RNA polymerase II complex component(CTR9)	Homo sapiens	Coronary Disease,Osteoporosis,
CWC22	CWC22 spliceosome associated protein homolog(CWC22)	Homo sapiens	Asthma,Carotid Arteries,Hematocrit,Hemoglobins,Lupus Erythematosus, Systemic,Myocardial Infarction,Obesity,Prostatic Neoplasms,Stroke,Tobacco Use Disorder,
CXXC1	CXXC finger protein 1(CXXC1)	Homo sapiens	Chronic lymphocytic leukemia,Leukemia, Lymphocytic, Chronic, B-Cell,
DCAF13	DDB1 and CUL4 associated factor 13(DCAF13)	Homo sapiens	Bone Mineral Density,Breath Tests,
DDX6	DEAD-box helicase 6(DDX6)	Homo sapiens	Liver Cirrhosis, Biliary,
DEK	DEK proto-oncogene(DEK)	Homo sapiens	Blood Pressure,Hemoglobins,rheumatoid arthritis,
DDX21	DExD-box helicase 21(DDX21)	Homo sapiens	Alzheimer's disease   ,
DDX50	DExD-box helicase 50(DDX50)	Homo sapiens	Depression,
DDIT4	DNA damage inducible transcript 4(DDIT4)	Homo sapiens	Uric Acid,
POLDIP2	DNA polymerase delta interacting protein 2(POLDIP2)	Homo sapiens	Acquired Immunodeficiency Syndrome|Disease Progression,
DNAJC3	DnaJ heat shock protein family (Hsp40) member C3(DNAJC3)	Homo sapiens	Lipoproteins, HDL,
DNAJC9	DnaJ heat shock protein family (Hsp40) member C9(DNAJC9)	Homo sapiens	Tobacco Use Disorder,
EFCAB14	EF-hand calcium binding domain 14(EFCAB14)	Homo sapiens	Cholesterol, HDL,Hepatitis C, Chronic,Schizophrenia,
ELAVL1	ELAV like RNA binding protein 1(ELAVL1)	Homo sapiens	Type 2 Diabetes| edema | rosiglitazone,
EML4	EMAP like 4(EML4)	Homo sapiens	Adenocarcinoma|Lung Neoplasms|Neoplasm of lung ,
FBXW11	F-box and WD repeat domain containing 11(FBXW11)	Homo sapiens	HIV Infections|[X]Human immunodeficiency virus disease,
FIBP	FGF1 intracellular binding protein(FIBP)	Homo sapiens	Type 2 Diabetes| edema | rosiglitazone,
FKBP5	FKBP prolyl isomerase 5(FKBP5)	Homo sapiens	Addison Disease,Alcoholism,Glaucoma, Open-Angle,HIV Infections,HIV Infections|[X]Human immunodeficiency virus disease,Inflammation,Marijuana Abuse|Psychoses, Substance-Induced,Psychiatric Disorders,Recurrence,Substance-Related Disorders,Tobacco Use Disorder,affective psychoses,asthma,bipolar disorder,depression,major depressive disorder,posttraumatic stress disorder,response to antidepressants,
FKBP8	FKBP prolyl isomerase 8(FKBP8)	Homo sapiens	Acquired Immunodeficiency Syndrome|Disease Progression,
FLII	FLII actin remodeling protein(FLII)	Homo sapiens	HIV Infections|[X]Human immunodeficiency virus disease,Type 2 Diabetes| edema | rosiglitazone,
FOSL2	FOS like 2, AP-1 transcription factor subunit(FOSL2)	Homo sapiens	Diabetes Mellitus, Type 1,Parkinson Disease,alcohol consumption,
FUS	FUS RNA binding protein(FUS)	Homo sapiens	Amyotrophic Lateral Sclerosis,Amyotrophic Lateral Sclerosis|,Amyotrophic Lateral Sclerosis|Frontotemporal dementia|Parkinsonian Disorders,Azoospermia|Infertility, Male|Oligospermia,Diabetes Mellitus, Type 2|Neoplasms|Obesity|Overweight,
FXYD5	FXYD domain containing ion transport regulator 5(FXYD5)	Homo sapiens	Behcet Syndrome,Type 2 Diabetes| edema | rosiglitazone,
GNL3	G protein nucleolar 3(GNL3)	Homo sapiens	Adiponectin,Bipolar Disorder,schizophrenia,
GNA13	G protein subunit alpha 13(GNA13)	Homo sapiens	Body Weights and Measures,Exercise Test,Leukocyte Count,Tobacco Use Disorder,Waist Circumference,
GNAI2	G protein subunit alpha i2(GNAI2)	Homo sapiens	Adenoma, Acidophil|Adenoma, Chromophobe|Pituitary Neoplasms,Type 2 Diabetes| edema | rosiglitazone,blood pressure, arterial,schizophrenia,
GSPT1	G1 to S phase transition 1(GSPT1)	Homo sapiens	Diabetes Mellitus,
GABARAPL2	GABA type A receptor associated protein like 2(GABARAPL2)	Homo sapiens	Bulimia,high-density lipoprotein cholesterol ,
GATA3	GATA binding protein 3(GATA3)	Homo sapiens	Asthma,Asthma|Bronchial Hyperreactivity|Hypersensitivity, Immediate,Asthma|Bronchiolitis, Viral|Respiratory Syncytial Virus Infections,Bronchiolitis, Viral|Respiratory Syncytial Virus Infections,Creatinine,Dermatitis, Atopic,Diabetes Mellitus,Erythrocyte Count,Hodgkin Disease,Hypersensitivity,Hypersensitivity, Immediate|Rhinitis,Hypertension,Precursor Cell Lymphoblastic Leukemia-Lymphoma,Respiratory Function Tests,Rhinitis, Allergic, Perennial,Sodium,Stroke,allergic rhinitis,asthma,bladder cancer,breast cancer,breast cancer   ,bronchodilator response,chronic obstructive pulmonary disease,lung cancer,lung cancer ,respiratory syncytial virus bronchiolitis,
GATAD2B	GATA zinc finger domain containing 2B(GATAD2B)	Homo sapiens	Lipoproteins,
HTATSF1	HIV-1 Tat specific factor 1(HTATSF1)	Homo sapiens	HIV Infections|[X]Human immunodeficiency virus disease,
HTRA2	HtrA serine peptidase 2(HTRA2)	Homo sapiens	Acquired Immunodeficiency Syndrome|Disease Progression,Parkinson's disease    ,
IK	IK cytokine(IK)	Homo sapiens	Celiac Disease,Narcolepsy,
IKZF1	IKAROS family zinc finger 1(IKZF1)	Homo sapiens	Acute lymphoblastic leukemia (childhood),Crohn Disease|Crohn's disease|Inflammatory bowel disease, NOS|Inflammatory Bowel Diseases,Hepatopulmonary Syndrome|Liver Cirrhosis,Lupus Erythematosus, Systemic,Lupus Erythematosus, Systemic|Lupus Nephritis|Nephritis SLE|Systemic lupus erythematosus,Neoplasm Recurrence, Local|Precursor Cell Lymphoblastic Leukemia-Lymphoma,acute lymphoblastic leukemia,hippocampal atrophy,leukemia,mean corpuscular volume,systemic lupus erythematosus,
ITK	IL2 inducible T cell kinase(ITK)	Homo sapiens	Body Mass Index,Body Weight Changes,Celiac Disease|,Personality,Rhinitis, Allergic, Seasonal,atopy; dermatitis and eczema,
JAK1	Janus kinase 1(JAK1)	Homo sapiens	Acute T Cell Leukemia|Leukemia-Lymphoma, Adult T-Cell,Asthma|Bronchiolitis, Viral|Respiratory Syncytial Virus Infections,Bronchiolitis, Viral|Respiratory Syncytial Virus Infections,Carcinoma, Hepatocellular|Liver Neoplasms,Dengue Hemorrhagic Fever,HIV Infections|[X]Human immunodeficiency virus disease,Hepatitis B, Chronic,Hepatitis B, Chronic|Viremia,Hepatitis C, Chronic|Liver Cirrhosis,Hepatitis C, Chronic|Neutropenia|Thrombocytopenia,Leukemia, Myeloid, Acute,Lymphoproliferative Disorders|Myelodysplastic Syndromes,Myeloproliferative Disorders|Philadelphia Chromosome|Polycythemia Vera|Primary Myelofibrosis|Thrombocythemia, Essential|Thrombocythemia, Hemorrhagic,Neoplasms,Polycythemia Vera|Primary Myelofibrosis,Precursor Cell Lymphoblastic Leukemia-Lymphoma,Tobacco Use Disorder,Type 2 Diabetes| edema | rosiglitazone,hepatitis B,multiple sclerosis,myeloid leukemia,respiratory syncytial virus bronchiolitis,thyroid cancer,
KIAA1191	KIAA1191(KIAA1191)	Homo sapiens	Alcoholism,
LBH	LBH regulator of WNT signaling pathway(LBH)	Homo sapiens	Albumins,Asthma,Celiac Disease|,F8 protein, human,Height,height,
LASP1	LIM and SH3 protein 1(LASP1)	Homo sapiens	Tobacco Use Disorder,autism,
LIMA1	LIM domain and actin binding 1(LIMA1)	Homo sapiens	Echocardiography,
LRRFIP2	LRR binding FLII interacting protein 2(LRRFIP2)	Homo sapiens	Tobacco Use Disorder,
LSM8	LSM8 homolog, U6 small nuclear RNA associated(LSM8)	Homo sapiens	Echocardiography,Hemoglobins,
LUC7L3	LUC7 like 3 pre-mRNA splicing factor(LUC7L3)	Homo sapiens	Narcolepsy,
MLX	MAX dimerization protein MLX(MLX)	Homo sapiens	Alzheimer's disease   ,
MLLT3	MLLT3 super elongation complex subunit(MLLT3)	Homo sapiens	Iron,Tobacco Use Disorder,lung cancer,
MORC3	MORC family CW-type zinc finger 3(MORC3)	Homo sapiens	Neuroblastoma,
MSL3	MSL complex subunit 3(MSL3)	Homo sapiens	Cholesterol, HDL,
MAZ	MYC associated zinc finger protein(MAZ)	Homo sapiens	Autism,
MEAF6	MYST/Esa1 associated factor 6(MEAF6)	Homo sapiens	Erythrocyte Count,Erythrocytes,
MRFAP1L1	Morf4 family associated protein 1 like 1(MRFAP1L1)	Homo sapiens	Iron,
NDRG1	N-myc downstream regulated 1(NDRG1)	Homo sapiens	Aging/ Telomere Length,Charcot-Marie-Tooth disease,Tobacco Use Disorder,cognitive trait,colorectal cancer,
NMT1	N-myristoyltransferase 1(NMT1)	Homo sapiens	HIV Infections|[X]Human immunodeficiency virus disease,Tobacco Use Disorder,
NDUFA2	NADH:ubiquinone oxidoreductase subunit A2(NDUFA2)	Homo sapiens	Acquired Immunodeficiency Syndrome|Disease Progression,drug-related genes ,
NCK1	NCK adaptor protein 1(NCK1)	Homo sapiens	longevity,
NFKBIA	NFKB inhibitor alpha(NFKBIA)	Homo sapiens	Adenocarcinoma|Stomach Neoplasms,Alcoholism|Liver Cirrhosis, Alcoholic,Arthritis, Psoriatic|Psoriasis|Psoriatic arthropathy,Arthritis, Rheumatoid|,Arthritis, Rheumatoid|Rheumatoid Arthritis,Arthritis, Rheumatoid|Rheumatoid Arthritis|Anti-TNF Response,Asthma|Bronchiolitis, Viral|Respiratory Syncytial Virus Infections,Behcet Syndrome,Bone Mineral Density,Bronchiolitis, Viral|Respiratory Syncytial Virus Infections,Carcinoma, Hepatocellular|Hepatitis B|Liver Cirrhosis|Liver Neoplasms,Chronic renal failure|Kidney Failure, Chronic,Connective Tissue Diseases|Fetal Diseases|Inflammation|Musculoskeletal Diseases|Pregnancy Complications, Hematologic|Premature Birth|Skin Diseases,Crohn's disease,Glioblastoma,Graves disease,HIV,Hodgkin Disease,Hodgkin Disease|Leukemia, Lymphocytic, Chronic, B-Cell|Lymphoproliferative Disorders|Waldenstrom Macroglobulinemia,Hodgkin's disease,Inflammation|Premature Birth,Inflammatory Bowel Diseases,Lupus Erythematosus, Systemic,Lymphoma, Non-Hodgkin,Multiple Myeloma,Precursor Cell Lymphoblastic Leukemia-Lymphoma,Psoriasis,Stroke,Tobacco Use Disorder,Type 2 Diabetes| edema | rosiglitazone,ankylosing spondylitis,atherosclerosis,autosomal dominant anhidrotic ectodermal dysplasia and T cell immunodeficiency,benzene haematotoxicity,breast cancer,breast cancer   ,colorectal cancer,diabetes, type 1,esophageal adenocarcinoma,insulin resistance,liver cancer,lung cancer,lung cancer ,melanoma,multiple myeloma,normal variation,ovarian cancer,ovarian cancer  ,plasma HDL cholesterol (HDL-C) levels,pneumococcal empyema pneumonia,respiratory syncytial virus bronchiolitis,rheumatoid arthritis,vascular disease,
NFU1	NFU1 iron-sulfur cluster scaffold(NFU1)	Homo sapiens	Acquired Immunodeficiency Syndrome|Disease Progression,
NME3	NME/NM23 nucleoside diphosphate kinase 3(NME3)	Homo sapiens	Acquired Immunodeficiency Syndrome|Disease Progression,
NSMCE3	NSE3 homolog, SMC5-SMC6 complex component(NSMCE3)	Homo sapiens	Attention Deficit Disorder with Hyperactivity,Heart Rate,
NUBP2	NUBP iron-sulfur cluster assembly factor 2, cytosolic(NUBP2)	Homo sapiens	Insulin-Like Growth Factor Binding Protein 5,bladder cancer,chronic obstructive pulmonary disease,lung cancer,lung cancer ,
OFD1	OFD1 centriole and centriolar satellite protein(OFD1)	Homo sapiens	Type 2 Diabetes| edema | rosiglitazone,
OLA1	Obg like ATPase 1(OLA1)	Homo sapiens	Tobacco Use Disorder,
PBX4	PBX homeobox 4(PBX4)	Homo sapiens	Cardiovascular Diseases,LDL cholesterol,Lipid Metabolism Disorders,triglycerides,
PML	PML nuclear body scaffold(PML)	Homo sapiens	Apoplexy|Cerebral Hemorrhage|Cerebral Hemorrhages|Intracranial Hemorrhages|Stroke|Subarachnoid Hemorrhage,Body Height,Leukemia, Lymphocytic, Chronic, B-Cell,Paget's disease,Tobacco Use Disorder,hypertension,leukemia,longevity,
RAB10	RAB10, member RAS oncogene family(RAB10)	Homo sapiens	Tobacco Use Disorder,
RAB11A	RAB11A, member RAS oncogene family(RAB11A)	Homo sapiens	Acquired Immunodeficiency Syndrome|Disease Progression,
RAB29	RAB29, member RAS oncogene family(RAB29)	Homo sapiens	Parkinson Disease,Parkinson's disease,
RAB2A	RAB2A, member RAS oncogene family(RAB2A)	Homo sapiens	Cholesterol, HDL,HIV Infections|[X]Human immunodeficiency virus disease,
RAB7A	RAB7A, member RAS oncogene family(RAB7A)	Homo sapiens	Erythrocyte Count,Hereditary Sensory and Autonomic Neuropathies,Neutrophils,
RAP1A	RAP1A, member of RAS oncogene family(RAP1A)	Homo sapiens	Blood Pressure,Carcinoma, Papillary|Thyroid Neoplasms,Echocardiography,Lipoproteins, VLDL,Osteoporosis,
RAP1B	RAP1B, member of RAS oncogene family(RAP1B)	Homo sapiens	Carcinoma, Papillary|Thyroid Neoplasms,HIV Infections|[X]Human immunodeficiency virus disease,
RASGRP1	RAS guanyl releasing protein 1(RASGRP1)	Homo sapiens	Autism,Bipolar Disorder,Bipolar disorder,Blood Pressure,Diabetes Mellitus, Type 1,Drug-Induced Liver Injury|Precursor Cell Lymphoblastic Leukemia-Lymphoma,diabetes, type 1 ,type 1 diabetes,
RBBP8	RB binding protein 8, endonuclease(RBBP8)	Homo sapiens	Adenocarcinoma|Pancreatic Neoplasms,Height,breast cancer   ,height,ovarian cancer  ,
RB1CC1	RB1 inducible coiled-coil 1(RB1CC1)	Homo sapiens	bladder cancer,chronic obstructive pulmonary disease,esophageal adenocarcinoma,lung cancer,lung cancer ,
REL	REL proto-oncogene, NF-kB subunit(REL)	Homo sapiens	Arthritis, Psoriatic,Arthritis, Rheumatoid,Arthritis, Rheumatoid|,Arthritis, Rheumatoid|Rheumatoid Arthritis,Arthritis, Rheumatoid|Rheumatoid Arthritis|Anti-TNF Response,Celiac Disease|,Celiac disease,Hodgkin Disease,Hodgkin Disease|Leukemia, Lymphocytic, Chronic, B-Cell|Lymphoproliferative Disorders|Waldenstrom Macroglobulinemia,Inflammation|Lymphoma, Non-Hodgkin|Lymphoma, Non-Hodgkin's,Lymphoma, Non-Hodgkin,Multiple Myeloma,Psoriasis,Type 2 Diabetes| edema | rosiglitazone,benzene haematotoxicity,normal variation,plasma HDL cholesterol (HDL-C) levels,rheumatoid arthritis,ulcerative colitis,
RELB	RELB proto-oncogene, NF-kB subunit(RELB)	Homo sapiens	Arthritis, Rheumatoid|,Arthritis, Rheumatoid|Rheumatoid Arthritis|Anti-TNF Response,Hodgkin Disease|Leukemia, Lymphocytic, Chronic, B-Cell|Lymphoproliferative Disorders|Waldenstrom Macroglobulinemia,Multiple Myeloma,Type 2 Diabetes| edema | rosiglitazone,benzene haematotoxicity,normal variation,plasma HDL cholesterol (HDL-C) levels,prostate cancer,
RBM17	RNA binding motif protein 17(RBM17)	Homo sapiens	Alzheimer's disease   ,Diabetes Mellitus, Insulin-Dependent|Diabetes Mellitus, Type 1,
RBMX	RNA binding motif protein X-linked(RBMX)	Homo sapiens	azoospermia,
RNPS1	RNA binding protein with serine rich domain 1(RNPS1)	Homo sapiens	Hemoglobin A, Glycosylated,
RTF1	RTF1 homolog, Paf1/RNA polymerase II complex component(RTF1)	Homo sapiens	Cholesterol, LDL,Tobacco Use Disorder,
RWDD1	RWD domain containing 1(RWDD1)	Homo sapiens	Cleft Lip|Cleft Palate|Tooth Abnormalities,
RABGGTB	Rab geranylgeranyltransferase subunit beta(RABGGTB)	Homo sapiens	Tobacco Use Disorder,
RAC1	Rac family small GTPase 1(RAC1)	Homo sapiens	Birth Weight|Leukemia|Leukemia, Myeloid, Acute|Precursor Cell Lymphoblastic Leukemia-Lymphoma,Brain Neoplasms|Occupational Diseases,HIV,Lymphoma, Non-Hodgkin,Meningeal Neoplasms|meningioma,Mental Retardation,bladder cancer,chronic obstructive pulmonary disease,coronary spastic angina,lung cancer,lung cancer ,
RALGAPA1	Ral GTPase activating protein catalytic subunit alpha 1(RALGAPA1)	Homo sapiens	Tobacco Use Disorder,
RAP1GDS1	Rap1 GTPase-GDP dissociation stimulator 1(RAP1GDS1)	Homo sapiens	Biochemical measures,Blood Flow Velocity,Lipids,Triglycerides,normal variation,
RSU1	Ras suppressor protein 1(RSU1)	Homo sapiens	Alzheimer's disease   ,Stroke,Tobacco Use Disorder,
ARHGDIB	Rho GDP dissociation inhibitor beta(ARHGDIB)	Homo sapiens	bladder cancer,chronic obstructive pulmonary disease,lung cancer,lung cancer ,prostate cancer,
ARHGAP25	Rho GTPase activating protein 25(ARHGAP25)	Homo sapiens	Electrocardiography,coronary spastic angina,
ARHGAP4	Rho GTPase activating protein 4(ARHGAP4)	Homo sapiens	Type 2 Diabetes| edema | rosiglitazone,
SKP1	S-phase kinase associated protein 1(SKP1)	Homo sapiens	Tobacco Use Disorder,
S100A10	S100 calcium binding protein A10(S100A10)	Homo sapiens	Dermatitis, Atopic|,antidepressant response,depressive disorder, major,major depressive disorder,thyroid cancer,
S100A11	S100 calcium binding protein A11(S100A11)	Homo sapiens	Hair,Tobacco Use Disorder,
S100A4	S100 calcium binding protein A4(S100A4)	Homo sapiens	Dermatitis, Atopic|,Hepatopulmonary Syndrome|Liver Cirrhosis,
SACM1L	SAC1 like phosphatidylinositide phosphatase(SACM1L)	Homo sapiens	Antidepressive Agents,
SLTM	SAFB like transcription modulator(SLTM)	Homo sapiens	Asperger Syndrome,Insulin,several psychiatric disorders,
SATB1	SATB homeobox 1(SATB1)	Homo sapiens	Alcoholism,Arteries,Cholesterol, HDL,Crohn Disease,Eosinophils,Inflammatory Bowel Diseases,Insulin,Insulin Resistance,Psoriasis,Tobacco Use Disorder,
SEC11C	SEC11 homolog C, signal peptidase complex subunit(SEC11C)	Homo sapiens	Pancreatic Neoplasms,
SETD2	SET domain containing 2, histone lysine methyltransferase(SETD2)	Homo sapiens	schizophrenia,
SFT2D1	SFT2 domain containing 1(SFT2D1)	Homo sapiens	HIV Infections|[X]Human immunodeficiency virus disease,
SH3BGRL	SH3 domain binding glutamate rich protein like(SH3BGRL)	Homo sapiens	obesity,
SH3GLB1	SH3 domain containing GRB2 like, endophilin B1(SH3GLB1)	Homo sapiens	Breast Neoplasms|Carcinoma|Carcinoma, Large Cell|Colorectal Neoplasms|Leukemia, Lymphoid|Lung Neoplasms|Neoplasms|Stomach Neoplasms,
SKIL	SKI like proto-oncogene(SKIL)	Homo sapiens	Chronic renal failure|Kidney Failure, Chronic,Prostatic Neoplasms,
SMAD2	SMAD family member 2(SMAD2)	Homo sapiens	Bone Mineral Density,Cleft Lip|Cleft Palate,Hepatopulmonary Syndrome|Liver Cirrhosis,Hypertension, Pulmonary,Obesity|POF - Premature ovarian failure|POLYCYSTIC OVARIAN SYNDROME|Polycystic Ovary Syndrome|Primary Ovarian Insufficiency|Puberty, Delayed|Puberty, Precocious|Thrombophilia|Tobacco Use Disorder,Pancreatic Neoplasms,bone density,colorectal cancer; Tourette syndrome; bone density; pregnancy loss, recurrent; cleft lip without cleft palate; juvenile polyposis; cleft palate,esophageal adenocarcinoma,inflammatory bowel disease   | colorectal cancer  ,
SNW1	SNW domain containing 1(SNW1)	Homo sapiens	Asthma|,
SPOCK2	SPARC (osteonectin), cwcv and kazal like domains proteoglycan 2(SPOCK2)	Homo sapiens	Alzheimer's disease   ,Insulin-Like Growth Factor I,breast cancer   ,
SPG7	SPG7 matrix AAA peptidase subunit, paraplegin(SPG7)	Homo sapiens	Acquired Immunodeficiency Syndrome|Disease Progression,Chronic renal failure|Kidney Failure, Chronic,Hemoglobin A, Glycosylated,Lipoproteins, VLDL,Motor Neuron Disease|Paraparesis, Spastic,multiple sclerosis,
SCAF4	SR-related CTD associated factor 4(SCAF4)	Homo sapiens	Albuminuria|Diabetic Nephropathies|Diabetic Nephropathy|Diabetic Retinopathy|Disease Progression,Birth Weight|Leukemia|Leukemia, Myeloid, Acute|Precursor Cell Lymphoblastic Leukemia-Lymphoma,Meningeal Neoplasms|meningioma,Type 2 Diabetes| edema | rosiglitazone,
SRPK1	SRSF protein kinase 1(SRPK1)	Homo sapiens	Tobacco Use Disorder,
SUN2	Sad1 and UNC84 domain containing 2(SUN2)	Homo sapiens	Inflammation|Lymphoma, Non-Hodgkin|Lymphoma, Non-Hodgkin's,
TBK1	TANK binding kinase 1(TBK1)	Homo sapiens	Coronary Artery Disease,Dengue Hemorrhagic Fever,Hepatitis C|Remission, Spontaneous,
TAOK3	TAO kinase 3(TAOK3)	Homo sapiens	Tobacco Use Disorder,
TBPL1	TATA-box binding protein like 1(TBPL1)	Homo sapiens	Azoospermia|Infertility, Male|Oligospermia,liver function; iron levels; ferritin; transferrin saturation,
TBC1D10C	TBC1 domain family member 10C(TBC1D10C)	Homo sapiens	Type 2 Diabetes| edema | rosiglitazone,
TBC1D4	TBC1 domain family member 4(TBC1D4)	Homo sapiens	Blood Pressure,Blood Pressure Determination,Carotid Stenosis,Tobacco Use Disorder,
TIPARP	TCDD inducible poly(ADP-ribose) polymerase(TIPARP)	Homo sapiens	Ovarian Neoplasms,celiac disease,ovarian cancer,
TGIF1	TGFB induced factor homeobox 1(TGIF1)	Homo sapiens	Alcoholism,Cholesterol, LDL,Cleft Lip|Cleft Palate,Myopia,Myopia, Degenerative,Waist Circumference,myopia,psychosis,
TIMP1	TIMP metallopeptidase inhibitor 1(TIMP1)	Homo sapiens	Alzheimer's Disease,Alzheimer's disease   ,Aortic Aneurysm, Abdominal,Arthritis, Rheumatoid|Rheumatoid Arthritis,COPD | Chronic obstructive Pulmonary Disease,Chorioamnionitis|Fetal Membranes, Premature Rupture|Infection of amniotic sac and membranes,Chorioamnionitis|Fetal Membranes, Premature Rupture|Infection of amniotic sac and membranes|Obstetric Labor, Premature|Pre-Eclampsia|Premature Birth,Constriction, Pathologic|Graft Occlusion, Vascular,Coronary Disease,Coronary Disease|Coronary heart disease|Diabetic Angiopathies|Myocardial Infarction,Crohn Disease|Recurrence,Crohn's disease ulcerative colitis,Duodenal Ulcer|Helicobacter Infections,Endometrial Neoplasms|,H. pylori infection stomach cancer,Helicobacter Infections|Metaplasia,Hepatitis C, Chronic|Liver Cirrhosis,Lymphoma, Non-Hodgkin,Spondylitis, Ankylosing,Type 2 Diabetes| edema | rosiglitazone,abdominal aortic aneurysm,aneurysm,arthritis,asthma,brain aneurysm,intracranial aneurysms,myopia,ovarian cancer,rectal cancer,restenosis,sclerosis, systemic,
TRAF1	TNF receptor associated factor 1(TRAF1)	Homo sapiens	Alzheimer's disease   ,Arthritis, Juvenile Rheumatoid|,Arthritis, Juvenile Rheumatoid|Arthritis, Rheumatoid|Chronic Childhood Arthritis|Rheumatoid Arthritis,Arthritis, Rheumatoid,Arthritis, Rheumatoid|,Arthritis, Rheumatoid|Atherosclerosis|Cardiovascular Diseases|Rheumatoid Arthritis,Arthritis, Rheumatoid|Cardiovascular Diseases|Neoplasms|Rheumatoid Arthritis,Arthritis, Rheumatoid|Lupus Erythematosus, Systemic,Arthritis, Rheumatoid|Neoplasms|Sepsis,Arthritis, Rheumatoid|Rheumatoid Arthritis,Arthritis|Arthritis, Juvenile Rheumatoid|Arthritis, Rheumatoid|Autoimmune Diseases|Lupus Erythematosus, Systemic,Autoimmune Diseases|Endometriosis,Autoimmune Diseases|Lupus Erythematosus, Systemic|Systemic lupus erythematosus,Bone Mineral Density,Glomerulonephritis, IGA|IGA Glomerulonephritides|Lupus Nephritis|Nephritis SLE,HIV,Inflammation|Lymphoma, Non-Hodgkin|Lymphoma, Non-Hodgkin's,Pemphigus,Rheumatic Heart Disease,Type 2 Diabetes| edema | rosiglitazone,Wegener's granulomatosis,alopecia areata,diabetes, type 1 ,giant cell arteritis,longevity,multiple autoimmune diseases,patent ductus arteriosus,rheumatoid arthritis,schizophrenia,systemic lupus erythematosus ,
TRAF3	TNF receptor associated factor 3(TRAF3)	Homo sapiens	Alzheimer's disease   ,Brain imaging in schizophrenia (interaction),HIV,Leukemia, Lymphocytic, Chronic, B-Cell,Schizophrenia,Type 2 Diabetes| edema | rosiglitazone,longevity,
TNFRSF14	TNF receptor superfamily member 14(TNFRSF14)	Homo sapiens	Arthritis, Rheumatoid|,Arthritis, Rheumatoid|Rheumatoid Arthritis,Brill-Symmers disease|Chromosome Deletion|Lymphoma, Follicular,Celiac disease,Colitis, Ulcerative,Hodgkin Disease|Leukemia, Lymphocytic, Chronic, B-Cell|Lymphoproliferative Disorders|Waldenstrom Macroglobulinemia,Multiple Myeloma,antibody response to pertussis vaccination,benzene haematotoxicity,diabetes, type 1 ,subacute sclerosing panencephalitis,
TNFRSF1A	TNF receptor superfamily member 1A(TNFRSF1A)	Homo sapiens	Abortion, Habitual|Abortion, Spontaneous,Acute Coronary Syndrome|,Aggressive Periodontitis|Alveolar Bone Loss|Chronic Periodontitis|Periodontal Attachment Loss|Periodontal Pocket|Periodontitis,Alzheimer's disease   ,Amyloidosis|Behcet Syndrome|Familial Mediterranean Fever|Irritable Bowel Syndrome,Arthritis, Rheumatoid|Rheumatoid Arthritis,Aspergillosis|Lung Diseases, Fungal,Asthma|Bronchiolitis, Viral|Respiratory Syncytial Virus Infections,Bone Mineral Density,Bronchiolitis, Viral|Respiratory Syncytial Virus Infections,Carcinoma, Squamous Cell|Mouth Neoplasms,Chorioamnionitis|Fetal Membranes, Premature Rupture|Infection of amniotic sac and membranes,Chorioamnionitis|Fetal Membranes, Premature Rupture|Infection of amniotic sac and membranes|Obstetric Labor, Premature|Pre-Eclampsia|Premature Birth,Congenital Heart Defects|Heart Defects, Congenital,Connective Tissue Diseases|Fetal Diseases|Inflammation|Musculoskeletal Diseases|Pregnancy Complications, Hematologic|Premature Birth|Skin Diseases,Crohn Disease,Crohn's disease,Crohn's disease; ulcerative colitis,Diarrhea|Familial Mediterranean Fever|Pain|Stomatitis, Aphthous,Endometriosis,Familial Mediterranean Fever,Familial Mediterranean Fever; hyper-IgD syndrome,Familial Mediterranean Fever|,Glaucoma, Open-Angle,Graft vs Host Disease,HIV,HTLV-1 infection,Hepatitis C|Remission, Spontaneous,Hereditary Autoinflammatory Diseases|Lymphadenitis|Pharyngitis|Stomatitis, Aphthous|Syndrome,Hypercholesterolemia|LDLC levels,Infection|Inflammation|Premature Birth,Inflammation|Premature Birth,Liver Cirrhosis, Biliary,Lupus Erythematosus, Systemic|Systemic lupus erythematosus,Lymphoma, Non-Hodgkin,Lymphoproliferative Disorders,Measles|Mumps|Rubella,Multiple Myeloma,Multiple Sclerosis,Osteoporosis, Postmenopausal,Parkinson's disease,Premature Birth,Rheumatic Diseases|Rheumatism,Rheumatoid Arthritis,Rheumatoid spondylitis|Spondylitis, Ankylosing,Spondylitis, Ankylosing,TRAPS|Pericarditis|,Thyroiditis, Autoimmune,Tumor necrosis factor receptor-associated periodic syndrome,Type 2 Diabetes| edema | rosiglitazone,alcohol,amyloidosis,anemia, iron deficiency; anemia of chronic disease,arthritis,arthritis, juvenile,atherosclerosis,atherosclerosis, coronary,benzene haematotoxicity,bladder cancer,breast cancer   ,chronic obstructive pulmonary disease,chronic obstructive pulmonary disease/COPD,cirrhosis,coronary artery disease,cystic fibrosis,diabetes, type 1,diabetes, type 2,diabetes, type 2; nephropathy in other diseases,esophageal adenocarcinoma,hepatitis C,inflammatory bowel disease ,lung cancer,lung cancer ,lupus erythematosus; rheumatoid arthritis,lymphoma,methamphetamine abuse,multiple sclerosis,myelopathy, HTLV-1 associated,myocardial infarct; carotid intima-media thickness,narcolepsy,obesity PAI-1 levels,osteoarthritis,paratyphoid feber typhoid fever,patent ductus arteriosus,periodic syndrome,preterm delivery,psoriatic arthritis,respiratory syncytial virus bronchiolitis,restenosis,rheumatoid arthritis,schizophrenia,sepsis,systemic lupus erythematosus,thrombosis, deep vein; Behcet's disease,tuberculosis tumor necrosis factor-alpha,uveitis,
TNFRSF1B	TNF receptor superfamily member 1B(TNFRSF1B)	Homo sapiens	Adrenal Hyperplasia, Congenital|Hyperandrogenism,Aggressive Periodontitis|Alveolar Bone Loss|Chronic Periodontitis|Periodontal Attachment Loss|Periodontal Pocket|Periodontitis,Alzheimer's disease,Alzheimer's disease   ,Anemia, Aplastic|Aplastic anemia|Genetic Diseases, Inborn|Graft vs Host Disease|Hematologic Neoplasms|Recurrence,Arthritis, Psoriatic|Psoriatic arthropathy,Arthritis, Rheumatoid,Arthritis, Rheumatoid|,Arthritis, Rheumatoid|Cardiovascular Diseases|Hypertension|Myocardial Ischemia|Pulmonary Embolism|Stroke|Venous Thrombosis,Arthritis, Rheumatoid|Osteoarthritis, Knee,Arthritis, Rheumatoid|Rheumatoid Arthritis,Arthritis, Rheumatoid|Rheumatoid Arthritis|Anti-TNF Response,Aspergillosis|Lung Diseases, Fungal,Asthma|Bronchiolitis, Viral|Respiratory Syncytial Virus Infections,Bacteremia|,Behcet Syndrome|Uveitis,Bone Mineral Density,Bronchiolitis, Viral|Respiratory Syncytial Virus Infections,Carcinoma, Squamous Cell|Esophageal Neoplasms|Lymphatic Metastasis|Oesophageal neoplasm|Squamous cell carcinoma,Carcinoma, Squamous Cell|Mouth Neoplasms,Chorioamnionitis|Fetal Membranes, Premature Rupture|Infection of amniotic sac and membranes,Chorioamnionitis|Fetal Membranes, Premature Rupture|Infection of amniotic sac and membranes|Obstetric Labor, Premature|Pre-Eclampsia|Premature Birth,Chronic renal failure|Kidney Failure, Chronic,Colitis, Ulcerative|Crohn Disease|,Connective Tissue Diseases|Fetal Diseases|Inflammation|Musculoskeletal Diseases|Pregnancy Complications, Hematologic|Premature Birth|Skin Diseases,Coronary Disease|Coronary heart disease,Crohn Disease,Crohn Disease|Rectal Fistula,Crohn's disease,Crohn's disease; ulcerative colitis,Endometriosis,Fractures, Bone|Osteoporosis, Postmenopausal,Graft vs Host Disease,Graft vs Host Disease|Leukemia,HTLV-1 infection,Hypercholesterolemia|LDLC levels,Hypertension|Insulin Resistance,Infection|Inflammation|Premature Birth,Inflammation|Myocardial Infarction,Inflammation|Premature Birth,Leukemia, Lymphocytic, Chronic, B-Cell,Leukemia, Myelogenous, Chronic, BCR-ABL Positive,Leukemia, Myelogenous, Chronic, BCR-ABL Positive|Neovascularization, Pathologic,Lichen Planus, Oral,Liver Diseases, Alcoholic,Lupus,Lupus Erythematosus, Systemic,Lupus Erythematosus, Systemic|Systemic lupus erythematosus,Lymphoma, Non-Hodgkin,Lymphoproliferative Disorders,Measles|Mumps|Rubella,Multiple Myeloma,Obesity,Osteoporosis,Osteoporosis, Postmenopausal,Premature Birth,Rheumatic Diseases|Rheumatism,Rheumatoid Arthritis,Rubella,Schizophrenia,Spondylitis, Ankylosing,Thyroiditis, Autoimmune,Type 2 Diabetes| edema | rosiglitazone,Type 2 diabetes,alcohol,anemia, iron deficiency; anemia of chronic disease,antineutrophil cytoplasmic antibody; (ANCA)-associated vasculitis,arthritis,arthritis, juvenile,atherosclerosis,atherosclerosis, coronary,autoimmune disease,benzene haematotoxicity,bone density,bone mass,bone mineral density,breast cancer,chronic obstructive pulmonary disease/COPD,coronary artery disease,diabetes, type 1,diabetes, type 2,diabetes, type 2; nephropathy in other diseases,endometriosis,human narcolepsy.,hypertension,idiopathic pulmonary fibrosis,inflammatory bowel disease ,lung cancer,lung cancer ,lupus erythematosus,lymphoma,multiple sclerosis,myelopathy, HTLV-1 associated,narcolepsy,obesity,obesity; polycystic ovarian syndrome; hyperandrogenism,osteoarthritis,ovarian cancer,patent ductus arteriosus,periodontitis,pneumonia,preterm delivery,psoriatic arthritis,pulmonary fibrosis; pneumoconiosis, coal workers',respiratory syncytial virus bronchiolitis,rheumatoid arthritis,schizophrenia,sclerosis, systemic,sepsis,silicosis,systemic lupus erythematosus,systemic lupus erythematosus; Buerger's disease; connective tissue disease, mixed; Takayasu's arteritis,tuberculosis ,uveitis,
TNFRSF25	TNF receptor superfamily member 25(TNFRSF25)	Homo sapiens	Multiple Myeloma,benzene haematotoxicity,diabetes, type 1,
TNFRSF4	TNF receptor superfamily member 4(TNFRSF4)	Homo sapiens	Acute Coronary Syndrome,Coronary Artery Disease,Hepatitis C|Remission, Spontaneous,Hypertension,Lupus Erythematosus, Systemic|Systemic lupus erythematosus,antibody response to pertussis vaccination,atherosclerosis,myocardial infarct,
TRIAP1	TP53 regulated inhibitor of apoptosis 1(TRIAP1)	Homo sapiens	Acquired Immunodeficiency Syndrome|Disease Progression,
TNIK	TRAF2 and NCK interacting kinase(TNIK)	Homo sapiens	Brain imaging in schizophrenia (interaction),Cell Adhesion Molecules,Cholesterol, HDL,Coronary Disease,Hemoglobins,Schizophrenia,Tobacco Use Disorder,schizophrenia,
TSC22D3	TSC22 domain family member 3(TSC22D3)	Homo sapiens	diabetes, type 2,
TAX1BP1	Tax1 binding protein 1(TAX1BP1)	Homo sapiens	Alcoholism|Head and Neck Neoplasms,Arthritis, Rheumatoid|,Obesity|POF - Premature ovarian failure|POLYCYSTIC OVARIAN SYNDROME|Polycystic Ovary Syndrome|Primary Ovarian Insufficiency|Puberty, Delayed|Puberty, Precocious|Thrombophilia|Tobacco Use Disorder,
UHMK1	U2AF homology motif kinase 1(UHMK1)	Homo sapiens	Bipolar Disorder,schizophrenia,
UBXN4	UBX domain protein 4(UBXN4)	Homo sapiens	Keratoconus,
UGP2	UDP-glucose pyrophosphorylase 2(UGP2)	Homo sapiens	Birth Weight|Hyperbilirubinemia, Neonatal,
UXS1	UDP-glucuronate decarboxylase 1(UXS1)	Homo sapiens	Acquired Immunodeficiency Syndrome|Disease Progression,Stroke,Tobacco Use Disorder,Type 2 Diabetes| edema | rosiglitazone,
VAPA	VAMP associated protein A(VAPA)	Homo sapiens	Bipolar Disorder,Blood Pressure Determination,Body Mass Index,Cholesterol, HDL,Coronary Artery Disease,Hemoglobin A, Glycosylated,Stroke,Waist Circumference,
VOPP1	VOPP1 WW domain binding protein(VOPP1)	Homo sapiens	hypertension,
VPS37B	VPS37B subunit of ESCRT-I(VPS37B)	Homo sapiens	Tobacco Use Disorder,
VRK3	VRK serine/threonine kinase 3(VRK3)	Homo sapiens	Chronic renal failure|Kidney Failure, Chronic,
WNK1	WNK lysine deficient protein kinase 1(WNK1)	Homo sapiens	Apoplexy|Brain Ischemia|Stroke,Chronic renal failure|Kidney Failure, Chronic,Essential Hypertension,HIV Infections|[X]Human immunodeficiency virus disease,Hereditary Sensory and Autonomic Neuropathies,Hypertension,Tobacco Use Disorder,Type 2 Diabetes| edema | rosiglitazone,blood pressure, arterial,hypertension,
WTAP	WT1 associated protein(WTAP)	Homo sapiens	serum markers of iron status,
XRCC5	X-ray repair cross complementing 5(XRCC5)	Homo sapiens	Adenocarcinoma|Carcinoma, Squamous Cell|Deglutition Disorders|Head and Neck Neoplasms|Radiodermatitis,Alcoholism,Brain Neoplasms|Glioma,Chronic Obstructive Pulmonary Disease,Chronic renal failure|Kidney Failure, Chronic,Colorectal Neoplasms,Coronary Disease,Head and Neck Neoplasms|Neoplasm Recurrence, Local|Neoplasms, Second Primary,Leukemia, Lymphocytic, Chronic, B-Cell,Leukemia, Myeloid|Myeloid Leukemia,Mouth Neoplasms|Precancerous Conditions,Multiple Myeloma,Tobacco Use Disorder,bladder cancer,brain cancer,breast cancer,breast cancer   ,cancer,chronic obstructive pulmonary disease,colorectal cancer,cytogenetic studies,endometrial cancer; cervical cancer; radiosensitivity, clinical,epithelial ovarian cancer ,esophageal adenocarcinoma,esophageal cancer gastric cardiac adenocarcinoma,head and neck cancer,lung cancer,lung cancer ,meningioma,multiple sclerosis,thyroid neoplasm|Thyroid Neoplasms,
YTHDF2	YTH N6-methyladenosine RNA binding protein F2(YTHDF2)	Homo sapiens	longevity,
YY1AP1	YY1 associated protein 1(YY1AP1)	Homo sapiens	Macular Degeneration,
YY1	YY1 transcription factor(YY1)	Homo sapiens	Type 2 Diabetes| edema | rosiglitazone,
YDJC	YdjC chitooligosaccharide deacetylase homolog(YDJC)	Homo sapiens	Autoimmune Diseases,Celiac Disease,
ACAA1	acetyl-CoA acyltransferase 1(ACAA1)	Homo sapiens	Acquired Immunodeficiency Syndrome|Disease Progression,Birth Weight|Leukemia|Leukemia, Myeloid, Acute|Precursor Cell Lymphoblastic Leukemia-Lymphoma,Meningeal Neoplasms|meningioma,Type 2 Diabetes| edema | rosiglitazone,high altitude performance,nephropathy, diabetic,
ACP1	acid phosphatase 1(ACP1)	Homo sapiens	Abortion, Spontaneous,Birth Weight,Cardiovascular Diseases|Obesity,Colonic Neoplasms|,Coronary Artery Disease|Diabetes Mellitus, Type 2|,Coronary Artery Disease|Diabetes mellitus type II|Diabetes Mellitus, Type 2,Diabetes Mellitus, Insulin-Dependent|Diabetes Mellitus, Type 1|Malaria,Diabetes Mellitus, Type 2|Diabetes, Gestational|Insulin Resistance,Endometriosis|Hypersensitivity,Epilepsy, Generalized|Epilepsy, Tonic-Clonic,Hypersensitivity,Leiomyoma|Uterine Neoplasms,Lupus Erythematosus, Systemic,Neoplasms,Obesity,Tobacco Use Disorder,Tourette syndrome,Type 2 Diabetes| edema | rosiglitazone,allergies,asthma,atherosclerosis, coronary; tuberculosis,cholesterol; triglycerides; obesity,cirrhosis, alcoholic,diabetes, type 1,diabetes, type 1 ,diabetes, type 2,glucose,haptoglobin development,intrauterine growth,obesity,obesity|asthma,osteoporosis, postmenopausal,triglyceride levels,tuberculosis,
ACTG1	actin gamma 1(ACTG1)	Homo sapiens	Dominant Progressive Deafness,
ACTR1B	actin related protein 1B(ACTR1B)	Homo sapiens	Stroke,
ARPC2	actin related protein 2/3 complex subunit 2(ARPC2)	Homo sapiens	Colitis, Ulcerative|,ulcerative colitis,
ACADVL	acyl-CoA dehydrogenase very long chain(ACADVL)	Homo sapiens	plasma HDL cholesterol (HDL-C) levels,
AP1G2	adaptor related protein complex 1 subunit gamma 2(AP1G2)	Homo sapiens	Death, Sudden, Cardiac,
AP2B1	adaptor related protein complex 2 subunit beta 1(AP2B1)	Homo sapiens	Platelet Count,
AP2M1	adaptor related protein complex 2 subunit mu 1(AP2M1)	Homo sapiens	HIV Infections|[X]Human immunodeficiency virus disease,Kidney Failure, Chronic,
AP3B1	adaptor related protein complex 3 subunit beta 1(AP3B1)	Homo sapiens	Brain Ischemia|Cardiovascular Diseases|Coronary Disease|Stroke,Carotid Artery Diseases,Coronary Disease|Coronary heart disease|Myocardial Infarction,Melanoma|Skin Neoplasms,Tobacco Use Disorder,Type 2 Diabetes| edema | rosiglitazone,atherosclerosis, coronary lipoprotein,schizophrenia,
AP3S1	adaptor related protein complex 3 subunit sigma 1(AP3S1)	Homo sapiens	Tobacco Use Disorder,Type 2 diabetes,
ADD1	adducin 1(ADD1)	Homo sapiens	Acute Coronary Syndrome|,Albuminuria|Hypertension,Alcohol Drinking,Amyotrophic Lateral Sclerosis|,Blood Cells,Blood Pressure,Body Weights and Measures,Brain Ischemia|Hypertension|Osteoporosis|Stroke,Brain Ischemia|Hypertension|Stroke,Cardiovascular Disease,Cardiovascular Diseases|,Carotid Artery Diseases|Vascular Diseases,Cerebral Hemorrhage|Cerebral Hemorrhages|Cerebrovascular Disorders|Hypertension,Cerebral Palsy,Cerebral Palsy|,Coronary Artery Disease,Coronary Artery Disease|Hypertension,Coronary Artery Disease|Hypertension|Myocardial Infarction|Stroke,Coronary Disease|Hyperlipoproteinemia Type II,Diabetes Mellitus, Type 2,Diabetes Mellitus, Type 2|Hypertension,Echocardiography,Endolymphatic Hydrops|Meniere Disease,Essential Hypertension,Hypertension,Hypertension, Pregnancy-Induced|Pre-Eclampsia,Hypertension|Myocardial Infarction,Hypertension|Myocardial Ischemia,Hypotension,IgA nephropathy,Kidney Failure,Meningococcal Infections,Migraine Disorders,Peripheral Vascular Diseases,Recurrence|Venous Thromboembolism,Stroke,Type 2 Diabetes| edema | rosiglitazone,Type 2 diabetes,albuminuria hypertension,alcoholism; renal disease, end stage,angiotensinogen hypertension,arterial stiffness,atherosclerosis, generalized cardiovascular disease cerebrovascular disease myocardial infarct stroke, ischemic,blood pressure,blood pressure, arterial,blood pressure, arterial diuretic effects heart rate hypokalemia,blood pressure, arterial intima-media thickness,blood pressure, arterial; nitric oxide production; salt sensitivity,blood pressure; hyperlipidemia, familial combined,brain hemorrhage,cardiac death,cardiovascular disease,cardiovascular disease; bilirubin,carotid and femoral artery stiffness,carotid intima-media thickness,creatinine; protein excretion, urinary,diabetes, type 2,diabetes, type 2 hypertension intima-media thickness mortality,familial combined hyperlipidemia,gastroschisis,heart anomalies, congenital,hematology indices,hypertension,hypertension, salt sensitive,intima-media thickness,kidney disease,left ventricular mass; renin activity,myocardial infarct,myocardial infarct stroke,myocardial infarction; stroke,nephropathy,nephropathy in other diseases,normal variation,plasma HDL cholesterol (HDL-C) levels,polycystic kidney disease,preterm delivery,renal disease, end stage,renin activity; aldosterone,restenosis,sodium transport rate, erythrocyte,stroke,
ADK	adenosine kinase(ADK)	Homo sapiens	Alzheimer's disease   ,Cholesterol, LDL,Fatigue|Sleep Disorders|Sleep Initiation and Maintenance Disorders,Tobacco Use Disorder,Tooth Eruption,Type 2 Diabetes| edema | rosiglitazone,diabetes, type 1,
ADSL	adenylosuccinate lyase(ADSL)	Homo sapiens	Acquired Immunodeficiency Syndrome|Disease Progression,height,
ADGRE5	adhesion G protein-coupled receptor E5(ADGRE5)	Homo sapiens	Chronic renal failure|Kidney Failure, Chronic,Type 2 Diabetes| edema | rosiglitazone,
AFTPH	aftiphilin(AFTPH)	Homo sapiens	Cholesterol,Cholesterol, LDL,Echocardiography,
MGAT4A	alpha-1,3-mannosyl-glycoprotein 4-beta-N-acetylglucosaminyltransferase A(MGAT4A)	Homo sapiens	Bipolar Disorder,Neoplasms,
AIMP1	aminoacyl tRNA synthetase complex interacting multifunctional protein 1(AIMP1)	Homo sapiens	Alcoholism,Blood Pressure,Blood Pressure Determination,Body Mass Index,Iron,Parkinson Disease,
AASDHPPT	aminoadipate-semialdehyde dehydrogenase-phosphopantetheinyl transferase(AASDHPPT)	Homo sapiens	Attention Deficit Disorder with Hyperactivity,Echocardiography,Heart Failure,Iron,Stroke,
ANKRD17	ankyrin repeat domain 17(ANKRD17)	Homo sapiens	Tobacco Use Disorder,
ANXA1	annexin A1(ANXA1)	Homo sapiens	Blood Pressure,Body Height,Body Mass Index,Cholesterol, HDL,Cholesterol, LDL,Creatinine,Erythrocytes,Glomerular Filtration Rate,Glucose,HIV-1,Heart Failure,Lipids,Pancreatic Neoplasms,Triglycerides,Type 2 Diabetes| edema | rosiglitazone,Waist Circumference,diabetes, type 2,
ANXA11	annexin A11(ANXA11)	Homo sapiens	Alzheimer's disease   ,Femur Head Necrosis|,Sarcoidosis,
ANXA5	annexin A5(ANXA5)	Homo sapiens	Cerebral Palsy,Cerebral Palsy|,Complication, Cardiovascular Pregnancy|Pregnancy Complications, Cardiovascular|Venous Thromboembolism,Diabetes Mellitus, Type 2,Femur Head Necrosis|,Hemorrhagic Disorders,Kidney Failure, Chronic,Myocardial Infarction,Pulmonary Disease, Chronic Obstructive,Tunica Media,Venous Thrombosis,annexin A5 antibodies,metabolic syndrome,myocardial infarct; cardiac death,preeclampsia,pregnancy complications,pregnancy loss,pregnancy loss, recurrent,
AATF	apoptosis antagonizing transcription factor(AATF)	Homo sapiens	breast cancer   ,kidney aging,obesity,
APEX1	apurinic/apyrimidinic endodeoxyribonuclease 1(APEX1)	Homo sapiens	Adenocarcinoma|Esophageal Neoplasms,Adenocarcinoma|Stomach Neoplasms,Adenomatous Polyposis Coli,Alzheimer's disease   ,Apoplexy|Stroke,Arsenic Poisoning,Biliary Tract Neoplasms|Gallstones,Brain Neoplasms|Glioma,Brain Neoplasms|Glioma|Meningeal Neoplasms|meningioma|Neuroma, Acoustic|Neuromas, Acoustic,Chromosome Aberrations|Chromosome abnormality|DNA Damage|Neoplasms,Chronic renal failure|Kidney Failure, Chronic,Cleft Lip|Cleft Palate,Colorectal Neoplasms,DNA Damage,DNA Damage|Helicobacter Infections|Precancerous Conditions|Stomach Neoplasms,DNA Damage|Radiation Injuries,DNA repair,Endometriosis,Esophageal Neoplasms|Head and Neck Neoplasms|Laryngeal Neoplasms|Mouth Neoplasms|Pharyngeal Neoplasms,Graft vs Host Disease,Graves Disease,Hematologic Neoplasms,Leukemia,Leukemia, Myeloid|Myeloid Leukemia,Lymphatic Metastasis|Thyroid Neoplasms,Lymphoma, Follicular|Lymphoma, Large B-Cell, Diffuse,Melanoma|Skin Neoplasms,Micronuclei, Chromosome-Defective,Myocardial Infarction,Neoplasms,Papillomavirus Infections|Uterine Cervical Neoplasms,Pre-Eclampsia,Pterygium,Stomach Neoplasms,Stroke,arsnic exposure,benzene toxicity,bladder cancer,bladder cancer leukemia lung cancer,breast cancer,breast cancer   ,cancer,cervical cancer,chromosome damage,chronic obstructive pulmonary disease,colorectal cancer,drug hypersensitivity leukemia,epithelial ovarian cancer ,esophageal adenocarcinoma,head and neck cancer,leukemia, childhood acute lymphoblastic,leukemia; bladder cancer; radiotherapy,lung cancer,lung cancer ,melanoma,melanoma|Skin Neoplasms,multiple sclerosis,nephropathy,neural tube defects; cleft lip with cleft palate; cleft lip without cleft palate,pancreatic cancer,prostate cancer,radiotherapy,radiotherapy response,radiotherapy sensitivity,skin lesions, arsenic-induced,subcutaneous fibrosis,upper aerodigestive tract cancer,
AQP3	aquaporin 3 (Gill blood group)(AQP3)	Homo sapiens	MENIERE DISEASE,Type 2 Diabetes| edema | rosiglitazone,
RSRP1	arginine and serine rich protein 1(RSRP1)	Homo sapiens	Blood Sedimentation,Myocardial Infarction,
ARMC10	armadillo repeat containing 10(ARMC10)	Homo sapiens	Acquired Immunodeficiency Syndrome|Disease Progression,Tobacco Use Disorder,
AHR	aryl hydrocarbon receptor(AHR)	Homo sapiens	1-hydroxypyrene, urinary,Alzheimer's disease   ,CYP1A1 levels in lung tissue,Cholesterol, HDL,Chronic renal failure|Kidney Failure, Chronic,Cleft Lip|Cleft Palate,Clozapine,Colorectal Neoplasms,Heart Rate,Laryngeal neoplasm|Laryngeal Neoplasms|Neoplasms, Second Primary|Neoplasms, Squamous Cell,Lung Neoplasms|Occupational Diseases,Lymphoma, Non-Hodgkin,Multiple Myeloma,Myocardial Infarction,Thyrotropin,azoospermia infertility, male oligospermia,azoospermia; oligospermia,bladder cancer,blood pressure, arterial,breast cancer,breast cancer   ,chronic obstructive pulmonary disease,coke-oven toxicity,colorectal cancer,dementia,endometriosis,esophageal adenocarcinoma,lung cancer,lung cancer ,lung cancer; CYP1A1 inducibility,lymphoma,lymphoma, Non-Hodgkin's,macular degeneration,micropenis,
ATXN1	ataxin 1(ATXN1)	Homo sapiens	Alzheimer Disease,Alzheimer's disease,Amyotrophic Lateral Sclerosis,Amyotrophic lateral sclerosis,Body Height,Body Mass Index,Body Weight,Cerebellar Ataxia|,Coronary Artery Disease,Creatinine,Eosinophils,Genomic Instability|Spinocerebellar Ataxias,Heart Failure,Life Expectancy,Lipoproteins,Macular Degeneration,Metabolism,Myocardial Infarction,Parkinson's disease,Spinocerebellar Ataxias,Stroke,Tobacco Use Disorder,carotid artery intima-media thickness; spinocerebellar ataxia; Huntington's disease; myotonic dystrophy,cognitive function,myotonic dystrophy type 1,restless legs syndrome,schizophrenia,schizophrenia; schizoaffective disorder; bipolar disorder,spinocerebellar ataxia,spinocerebellar ataxia; Huntington's disease; myotonic dystrophy,trinucleotide expansion disease,
ATG3	autophagy related 3(ATG3)	Homo sapiens	Chronic progressive chorea|Huntington Disease,
BSG	basigin (Ok blood group)(BSG)	Homo sapiens	Type 2 Diabetes| edema | rosiglitazone,
BOD1L1	biorientation of chromosomes in cell division 1 like 1(BOD1L1)	Homo sapiens	Tobacco Use Disorder,
BAZ1B	bromodomain adjacent to zinc finger domain 1B(BAZ1B)	Homo sapiens	Caffeine,Cardiovascular Diseases,Fredrickson hyperlipoproteinemia,Hypertriglyceridemia,Protein C,Triglycerides,Type 2 Diabetes| edema | rosiglitazone,Type 2 diabetes,
CREB1	cAMP responsive element binding protein 1(CREB1)	Homo sapiens	Alcoholism,Alzheimer's disease   ,Bulimia,Diabetes mellitus|Diabetes mellitus type II|Diabetes Mellitus, Type 2,Inflammation|Lymphoma, Non-Hodgkin|Lymphoma, Non-Hodgkin's,Lithium response,Type 2 Diabetes| edema | rosiglitazone,alcohol consumption,anger expression,antipsychotic response | Weight Gain,asthma,bronchodilator response,childhood-onset mood disorders,depression,major depressive disorder,plasma HDL cholesterol (HDL-C) levels,suicide,
CALCOCO2	calcium binding and coiled-coil domain 2(CALCOCO2)	Homo sapiens	Neuroblastoma,
CALM1	calmodulin 1(CALM1)	Homo sapiens	Brain Ischemia|Cardiovascular Diseases|Coronary Disease|Stroke,Bulimia,Coronary Disease|Coronary heart disease|Myocardial Infarction,Osteoarthritis, Knee,Schizophrenia,Scoliosis,Triglycerides,Type 2 Diabetes| edema | rosiglitazone,Waist-Hip Ratio,atherosclerosis, coronary lipoprotein,osteoarthritis,
CANX	calnexin(CANX)	Homo sapiens	Type 2 Diabetes| edema | rosiglitazone,nephrogenic diabetes insipidus,
CAPZA1	capping actin protein of muscle Z-line subunit alpha 1(CAPZA1)	Homo sapiens	Blood Pressure,
CAPG	capping actin protein, gelsolin like(CAPG)	Homo sapiens	Carotid Artery Diseases|Hyperlipoproteinemia Type II,
CSNK1D	casein kinase 1 delta(CSNK1D)	Homo sapiens	Aging/ Telomere Length,Communicable Diseases|Coronary Disease|Coronary heart disease|Degenerative arthropathy |Diabetes mellitus|Hyperparathyroidism|Neoplasms|Osteoarthritis|Osteoporosis, Postmenopausal|Psoriasis,bipolar disorder,breast cancer,breast cancer   ,cognitive trait,schizophrenia | bipolar disorder,
CASP3	caspase 3(CASP3)	Homo sapiens	Adenocarcinoma|Lymphatic Metastasis|Stomach Neoplasms,Adenocarcinoma|Neoplasms, Prostatic|Prostatic Neoplasms,Autism,Bone Mineral Density,Carcinoma, Squamous Cell|Head and Neck Neoplasms,Chronic renal failure|Kidney Failure, Chronic,Diabetic Nephropathies|Diabetic Nephropathy,Endometrial Neoplasms|,Gastrointestinal Stromal Tumors,Hematocrit,Hemoglobins,Hodgkin Disease|Leukemia, Lymphocytic, Chronic, B-Cell|Lymphoproliferative Disorders|Waldenstrom Macroglobulinemia,Leukemia, Lymphocytic, Chronic, B-Cell,Leukemia, Myelogenous, Chronic, BCR-ABL Positive,Leukemia, Myelogenous, Chronic, BCR-ABL Positive|Neovascularization, Pathologic,Lymphoma, Non-Hodgkin,Lymphoma, Non-Hodgkin|Lymphoma, Non-Hodgkin's,Mucocutaneous Lymph Node Syndrome,Multiple Myeloma,Type 2 Diabetes| edema | rosiglitazone,benzene haematotoxicity,bladder cancer,chronic obstructive pulmonary disease,clubfoot,colorectal cancer,esophageal adenocarcinoma,lung cancer,lung cancer ,lymphoma, non-Hodgkin,multiple sclerosis,
CASP4	caspase 4(CASP4)	Homo sapiens	Adenocarcinoma|Neoplasms, Prostatic|Prostatic Neoplasms,Gastrointestinal Stromal Tumors,Hodgkin Disease|Leukemia, Lymphocytic, Chronic, B-Cell|Lymphoproliferative Disorders|Waldenstrom Macroglobulinemia,Lymphoma, Non-Hodgkin,Lymphoma, Non-Hodgkin|Lymphoma, Non-Hodgkin's,benzene haematotoxicity,esophageal adenocarcinoma,
CASP8	caspase 8(CASP8)	Homo sapiens	Acquired Immunodeficiency Syndrome|Disease Progression,Adenocarcinoma|Neoplasms, Prostatic|Prostatic Neoplasms,Anthracosis|,Asthma|Bronchial Hyperreactivity,Bone Mineral Density,Brain Neoplasms|Glioma|meningioma|Neuroma, Acoustic|Neuromas, Acoustic,Breast Neoplasms|Colorectal Neoplasms|Prostatic Neoplasms,Breast Neoplasms|Mammary Neoplasms,Carcinoma, Renal Cell|Renal Cell Carcinoma,Carcinoma, Squamous Cell|Head and Neck Neoplasms|Squamous cell carcinoma,Diabetes Mellitus|Pancreatic Neoplasms,Endometrial Neoplasms|,Gastrointestinal Stromal Tumors,Glioma,Head and Neck Neoplasms|Neoplasm Recurrence, Local|Neoplasms, Second Primary,Hepatitis C, Chronic|HIV Infections|Liver Diseases,Hodgkin Disease|Leukemia, Lymphocytic, Chronic, B-Cell|Lymphoproliferative Disorders|Waldenstrom Macroglobulinemia,Infertility, Male,Leukemia, Lymphocytic, Chronic, B-Cell,Leukemia, Myelogenous, Chronic, BCR-ABL Positive,Leukemia, Myelogenous, Chronic, BCR-ABL Positive|Neovascularization, Pathologic,Lymphoma, Non-Hodgkin,Lymphoma, Non-Hodgkin|Lymphoma, Non-Hodgkin's,Melanoma|Skin Neoplasms,Meningeal Neoplasms|Meningioma,Multiple Myeloma,Narcolepsy,Neoplasms,Type 2 Diabetes| edema | rosiglitazone,benzene haematotoxicity,bladder cancer,breast cancer,breast cancer   ,breast cancer cervical cancer colorectal cancer esophageal cancer lung cancer stomach cancer,breast cancer|ovarian cancer,chronic obstructive pulmonary disease,clubfoot,colorectal cancer,esophageal adenocarcinoma,longevity,lung cancer,lung cancer ,lymphoma, non-Hodgkin,multiple sclerosis,ovarian cancer,ovarian cancer  ,prostate cancer,prostate carcinoma,rubella vaccine,
CTSB	cathepsin B(CTSB)	Homo sapiens	Calcinosis|Diabetes Mellitus, Type 2|Pancreatitis, Chronic,Calcinosis|Pancreatitis,Chronic renal failure|Kidney Failure, Chronic,Type 2 Diabetes| edema | rosiglitazone,bladder cancer,colorectal cancer,pancreatitis, tropical calcific,prostate cancer,
CTSC	cathepsin C(CTSC)	Homo sapiens	Body Weight,Breath Tests,Cholesterol, HDL,Liver Diseases,Periodontitis,cardiovascular disease; periodontal disease,
CDC123	cell division cycle 123(CDC123)	Homo sapiens	Alzheimer's disease   ,Diabetes Mellitus, Type 2,Diabetes Mellitus, Type 2|,Diabetes Mellitus|Diabetes Mellitus, Type 2|,Diabetes mellitus|HIV Infections|[X]Human immunodeficiency virus disease,Hemoglobin A, Glycosylated,Posttransplantation diabetes mellitus (PTDM),Respiratory Function Tests,Tobacco Use Disorder,Type 2 diabetes,diabetes, type 2,obesity,type 2 diabetes,
CDC25B	cell division cycle 25B(CDC25B)	Homo sapiens	Bipolar Disorder,bladder cancer,breast cancer,chronic obstructive pulmonary disease,lung cancer,lung cancer ,ovarian cancer,
CDC40	cell division cycle 40(CDC40)	Homo sapiens	Colorectal Neoplasms|,
CDC5L	cell division cycle 5 like(CDC5L)	Homo sapiens	Amyotrophic Lateral Sclerosis,Body Height,Celiac Disease|,
CCAR1	cell division cycle and apoptosis regulator 1(CCAR1)	Homo sapiens	Alzheimer's disease   ,
CNTRL	centriolin(CNTRL)	Homo sapiens	Tobacco Use Disorder,breast cancer,
CENPC	centromere protein C(CENPC)	Homo sapiens	Bipolar Disorder,Cholesterol,Parkinson Disease,multiple sclerosis (severity),
CEP57	centrosomal protein 57(CEP57)	Homo sapiens	Type 2 Diabetes| edema | rosiglitazone,
CERS2	ceramide synthase 2(CERS2)	Homo sapiens	Chronic renal failure|Kidney Failure, Chronic,Kidney Diseases,
CRBN	cereblon(CRBN)	Homo sapiens	Bipolar Disorder,Blood Pressure,Bone Density,C-Reactive Protein,Cholesterol, HDL,Creatinine,Echocardiography,Fibrinogen,Hemoglobin A, Glycosylated,Iron,Lipoproteins, VLDL,Neutrophils,Pancreatic Neoplasms,Prostatic Neoplasms,Tunica Media,Vitamin K,
CCT2	chaperonin containing TCP1 subunit 2(CCT2)	Homo sapiens	Apoplexy|Cerebral Hemorrhage|Cerebral Hemorrhages|Intracranial Hemorrhages|Stroke|Subarachnoid Hemorrhage,Creatinine,height,hypertension,
CCT3	chaperonin containing TCP1 subunit 3(CCT3)	Homo sapiens	Cleft Lip|Cleft Palate,
CHMP1B	charged multivesicular body protein 1B(CHMP1B)	Homo sapiens	Bipolar Disorder,bipolar disorder,
CHMP5	charged multivesicular body protein 5(CHMP5)	Homo sapiens	Erectile Dysfunction,
CLNS1A	chloride nucleotide-sensitive channel 1A(CLNS1A)	Homo sapiens	HIV Infections|[X]Human immunodeficiency virus disease,Tobacco Use Disorder,
CSGALNACT2	chondroitin sulfate N-acetylgalactosaminyltransferase 2(CSGALNACT2)	Homo sapiens	Alzheimer's disease   ,Hirschsprung's disease,Monocytes,
CHD2	chromodomain helicase DNA binding protein 2(CHD2)	Homo sapiens	Hypertension,Tobacco Use Disorder,
C12ORF57	chromosome 12 open reading frame 57(C12orf57)	Homo sapiens	Alzheimer's disease   ,
CS	citrate synthase(CS)	Homo sapiens	Acquired Immunodeficiency Syndrome|Disease Progression,Body Height,spermatogenesis,
COQ10B	coenzyme Q10B(COQ10B)	Homo sapiens	Acquired Immunodeficiency Syndrome|Disease Progression,
CCSER2	coiled-coil serine rich protein 2(CCSER2)	Homo sapiens	Alzheimer's disease   ,Lipids,Tobacco Use Disorder,Triglycerides,
CSDE1	cold shock domain containing E1(CSDE1)	Homo sapiens	Chronic renal failure|Kidney Failure, Chronic,Tobacco Use Disorder,Type 2 Diabetes| edema | rosiglitazone,
C1QBP	complement C1q binding protein(C1QBP)	Homo sapiens	Acquired Immunodeficiency Syndrome|Disease Progression,Birth Weight|Leukemia|Leukemia, Myeloid, Acute|Precursor Cell Lymphoblastic Leukemia-Lymphoma,Meningeal Neoplasms|meningioma,Type 2 Diabetes| edema | rosiglitazone,
CPNE3	copine 3(CPNE3)	Homo sapiens	Hip,
CCS	copper chaperone for superoxide dismutase(CCS)	Homo sapiens	Aging/ Telomere Length,cognitive trait,
CUL4A	cullin 4A(CUL4A)	Homo sapiens	longevity,
CUTA	cutA divalent cation tolerance homolog(CUTA)	Homo sapiens	Lupus Erythematosus, Systemic,
CAP1	cyclase associated actin cytoskeleton regulatory protein 1(CAP1)	Homo sapiens	Type 2 diabetes,
CCND2	cyclin D2(CCND2)	Homo sapiens	Carcinoma, Hepatocellular|Hepatitis B|LCC - Liver cell carcinoma|Liver neoplasms,Chronic renal failure|Kidney Failure, Chronic,Leukemia, Lymphoid,Narcolepsy,breast cancer,breast cancer   ,diabetes, type 2,major depressive disorder,ovarian cancer,ovarian cancer  ,
CCND3	cyclin D3(CCND3)	Homo sapiens	Alzheimer's disease   ,Body Fat Distribution,Body Mass Index,Body Weight,Breast Neoplasms,Chronic renal failure|Kidney Failure, Chronic,Erythrocyte Count,Erythrocyte Indices,Neutrophils,Waist Circumference,Waist-Hip Ratio,bladder cancer,breast cancer,breast cancer   ,chronic obstructive pulmonary disease,esophageal adenocarcinoma,hematological parameters,lung cancer,lung cancer ,mean corpuscular hemoglobin,mean corpuscular volume,ovarian cancer,ovarian cancer  ,plasma HDL cholesterol (HDL-C) levels,
GAK	cyclin G associated kinase(GAK)	Homo sapiens	Chronic renal failure|Kidney Failure, Chronic,Parkinson Disease,Parkinson's disease,Parkinson's disease (familial),
CCNH	cyclin H(CCNH)	Homo sapiens	Biliary Tract Neoplasms|,Body Mass Index,Brain Neoplasms|Glioma|meningioma|Neuroma, Acoustic|Neuromas, Acoustic,Chronic renal failure|Kidney Failure, Chronic,Colorectal Neoplasms,Fibrinogen,Hemoglobins,Hypertrophy, Left Ventricular,Insulin,Insulin Resistance,Leukemia, Lymphocytic, Chronic, B-Cell,Leukemia, Myeloid, Acute,Neoplasms,bladder cancer,body mass; diabetes, type 2; leukemia; breast cancer; glucose; cytogenetic studies; birth weight;,chronic obstructive pulmonary disease,colorectal cancer,esophageal cancer ,lung cancer,lung cancer ,multiple sclerosis,oral premalignant lesions,
CDK17	cyclin dependent kinase 17(CDK17)	Homo sapiens	Body Weight,Fibrinogen,Parkinson Disease,Phospholipids,neurofibromatosis 1,
CDK4	cyclin dependent kinase 4(CDK4)	Homo sapiens	Brain Neoplasms|Glioblastoma,Breast Neoplasms|Mammary Neoplasms|melanoma|ovarian neoplasm|Ovarian Neoplasms|Uveal Neoplasms,Chronic renal failure|Kidney Failure, Chronic,Diabetes Mellitus, Type 2|Obesity,Glioma,Head and Neck Neoplasms|Neoplasm Recurrence, Local|Neoplasms, Second Primary,Lymphoma, Non-Hodgkin,Melanoma|Neoplasms, Second Primary,Melanoma|Skin Neoplasms,Mouth Neoplasms|Precancerous Conditions,Neoplasms|Obesity,Type 2 Diabetes| edema | rosiglitazone,bladder cancer,body mass; diabetes, type 2; glucose; birth weight,breast cancer,breast cancer   ,chronic obstructive pulmonary disease,diabetes, type 2,esophageal adenocarcinoma,leukemia, childhood acute lymphoblastic,lung cancer,lung cancer ,melanoma,melanoma, sporadic primary,melanoma|Skin Neoplasms,ovarian cancer,ovarian cancer  ,pancreatic cancer,
COX7A2	cytochrome c oxidase subunit 7A2(COX7A2)	Homo sapiens	Acquired Immunodeficiency Syndrome|Disease Progression,prostate cancer,
CRLF3	cytokine receptor like factor 3(CRLF3)	Homo sapiens	Craniofacial Abnormalities|Growth Disorders|Learning Disorders|Syndrome,Height,height,ovarian cancer,
DAXX	death domain associated protein(DAXX)	Homo sapiens	Cholesterol,Lupus Erythematosus, Systemic,Precursor Cell Lymphoblastic Leukemia-Lymphoma,diabetes, type 1,
DCP1B	decapping mRNA 1B(DCP1B)	Homo sapiens	Bilirubin,Hemoglobin A, Glycosylated,Pancreatic Neoplasms,
DOCK10	dedicator of cytokinesis 10(DOCK10)	Homo sapiens	Attention Deficit Disorder with Hyperactivity,
DUT	deoxyuridine triphosphatase(DUT)	Homo sapiens	Acquired Immunodeficiency Syndrome|Disease Progression,Adiponectin,DNA Damage|,Myocardial Infarction,protein quantitative trait loci,
DBI	diazepam binding inhibitor, acyl-CoA binding protein(DBI)	Homo sapiens	alcohol consumption,anxiety disorder panic disorder,diabetes, type 2,several psychiatric disorders,
DLST	dihydrolipoamide S-succinyltransferase(DLST)	Homo sapiens	Acquired Immunodeficiency Syndrome|Disease Progression,Alzheimer's Disease,Alzheimer's disease   ,Alzheimer's disease; Wernicke-Korsakoff syndrome,Tobacco Use Disorder,
DOK2	docking protein 2(DOK2)	Homo sapiens	Type 2 Diabetes| edema | rosiglitazone,
DDOST	dolichyl-diphosphooligosaccharide--protein glycosyltransferase non-catalytic subunit(DDOST)	Homo sapiens	Diabetes Mellitus, Insulin-Dependent|Diabetes Mellitus, Type 1|Diabetic Nephropathies|Diabetic Nephropathy,Diabetes Mellitus, Type 2,HIV Infections|[X]Human immunodeficiency virus disease,drug-related genes ,
DUSP12	dual specificity phosphatase 12(DUSP12)	Homo sapiens	Diabetes Mellitus, Type 2,Diabetes mellitus type II|Diabetes Mellitus, Type 2,Neuroblastoma,diabetes, type 2,
DYNLL1	dynein light chain LC8-type 1(DYNLL1)	Homo sapiens	Tobacco Use Disorder,
EMB	embigin(EMB)	Homo sapiens	Alcoholism,
EPS15	epidermal growth factor receptor pathway substrate 15(EPS15)	Homo sapiens	Chronic renal failure|Kidney Failure, Chronic,Cleft Lip|Cleft Palate,Rhinitis, Allergic, Seasonal,
ESCO1	establishment of sister chromatid cohesion N-acetyltransferase 1(ESCO1)	Homo sapiens	Leukemia, Lymphocytic, Chronic, B-Cell,prostate cancer,
ETNK1	ethanolamine kinase 1(ETNK1)	Homo sapiens	Tobacco Use Disorder,Type 2 Diabetes| edema | rosiglitazone,von Willebrand Factor,
EEF2	eukaryotic translation elongation factor 2(EEF2)	Homo sapiens	Tobacco Use Disorder,
EIF3F	eukaryotic translation initiation factor 3 subunit F(EIF3F)	Homo sapiens	Depression,
EIF3H	eukaryotic translation initiation factor 3 subunit H(EIF3H)	Homo sapiens	Cholesterol, HDL,HIV Infections|[X]Human immunodeficiency virus disease,colorectal cancer,lung cancer ,
EIF3L	eukaryotic translation initiation factor 3 subunit L(EIF3L)	Homo sapiens	Monocytes,
FIP1L1	factor interacting with PAPOLA and CPSF1(FIP1L1)	Homo sapiens	Potassium,
FAM107B	family with sequence similarity 107 member B(FAM107B)	Homo sapiens	Alzheimer's disease   ,Blood Pressure,Cholesterol,Creatinine,Glomerular Filtration Rate,Hip,Tobacco Use Disorder,Type 2 Diabetes| edema | rosiglitazone,
FAM177A1	family with sequence similarity 177 member A1(FAM177A1)	Homo sapiens	Arthritis, Juvenile Rheumatoid|Chronic Childhood Arthritis,Body Weights and Measures,Waist Circumference,
FDX1	ferredoxin 1(FDX1)	Homo sapiens	Acquired Immunodeficiency Syndrome|Disease Progression,Arteries,Insulin,Obesity,Tobacco Use Disorder,lung cancer,smoking cessation,
FLNA	filamin A(FLNA)	Homo sapiens	Bulimia,Type 2 Diabetes| edema | rosiglitazone,
GLA	galactosidase alpha(GLA)	Homo sapiens	Apoplexy|Fabry Disease|Stroke,Fabry Disease,Fabry disease,Type 2 Diabetes| edema | rosiglitazone,left ventricular wall thickness,
GLB1	galactosidase beta 1(GLB1)	Homo sapiens	Tobacco Use Disorder,
LGALS1	galectin 1(LGALS1)	Homo sapiens	Myasthenia Gravis,Type 2 Diabetes| edema | rosiglitazone,thyroid cancer,
LGALS3	galectin 3(LGALS3)	Homo sapiens	Body Weight,Diabetes Mellitus, Insulin-Dependent|Diabetes Mellitus, Type 1|Diabetic Nephropathies|Diabetic Nephropathy,Type 2 Diabetes| edema | rosiglitazone,longevity,thyroid cancer,
GTF2E2	general transcription factor IIE subunit 2(GTF2E2)	Homo sapiens	Cognitive performance ,ulcerative colitis,
GPI	glucose-6-phosphate isomerase(GPI)	Homo sapiens	Carcinoma, Pancreatic Ductal|Pancreatic Neoplasms,hereditary nonspherocytic hemolytic anemia (HNSHA).,
GCLM	glutamate-cysteine ligase modifier subunit(GCLM)	Homo sapiens	2-thiothiazolidine-4-carboxylic acid levels,Asthma,Atherosclerosis|Carotid Artery Diseases|Diabetes Mellitus, Type 2|,Atherosclerosis|Diabetes Complications|Diabetes mellitus type II|Diabetes Mellitus, Type 2|Myocardial Infarction,Coronary Disease,Glomerulonephritis, IGA,Kidney Failure, Chronic,Pulmonary Disease, Chronic Obstructive,Schizophrenia,Type 2 Diabetes| edema | rosiglitazone,arsnic exposure,atherosclerosis,atherosclerosis, coronary,berylliosis,body burden of methylmercury,chronic obstructive pulmonary disease/COPD,cognitive impairment, vascular stroke, ischemic,immunologic markers among vulcanization workers ,lung cancer,metabolic syndrome,methylmercury retention,myocardial infarction,schizophrenia,
GLRX	glutaredoxin(GLRX)	Homo sapiens	Acquired Immunodeficiency Syndrome|Disease Progression,Aging/ Telomere Length,Blood Pressure,Hypertension|Pre-Eclampsia|Pregnancy Complications,arsenic ,arsnic exposure,cognitive trait,
GPAA1	glycosylphosphatidylinositol anchor attachment 1(GPAA1)	Homo sapiens	Metabolism,
GLO1	glyoxalase I(GLO1)	Homo sapiens	Albuminuria|Diabetes Mellitus, Type 2,Alcoholism,Autism,Chronic renal failure|Kidney Failure, Chronic|Uremia,Diabetes mellitus type II|Diabetes Mellitus, Type 2|pancreatic neoplasm|Pancreatic Neoplasms,Kidney Failure, Chronic|Vascular Diseases,Psychiatric Disorders,Tobacco Use Disorder,Vascular Diseases,atherosclerosis, coronary; tuberculosis,autism,breast cancer,breast cancer   ,cirrhosis, alcoholic,metabolic syndrome,multiple sclerosis,panic disorder,pro-thrombotic factors,tuberculosis,
GLOD4	glyoxalase domain containing 4(GLOD4)	Homo sapiens	Acquired Immunodeficiency Syndrome|Disease Progression,
GOLGA7	golgin A7(GOLGA7)	Homo sapiens	Type 2 Diabetes| edema | rosiglitazone,
GHITM	growth hormone inducible transmembrane protein(GHITM)	Homo sapiens	Acquired Immunodeficiency Syndrome|Disease Progression,Alzheimer's disease   ,Head and Neck Neoplasms|Neoplasm Recurrence, Local|Neoplasms, Second Primary,
GBP2	guanylate binding protein 2(GBP2)	Homo sapiens	Cholesterol, LDL,hepatitis B,
GBP4	guanylate binding protein 4(GBP4)	Homo sapiens	Myocardial Infarction,Tobacco Use Disorder,
HSP90AB1	heat shock protein 90 alpha family class B member 1(HSP90AB1)	Homo sapiens	Chronic renal failure|Kidney Failure, Chronic,Type 2 Diabetes| edema | rosiglitazone,asthma,benzene haematotoxicity,
HSPA8	heat shock protein family A (Hsp70) member 8(HSPA8)	Homo sapiens	Aging/ Telomere Length,Aneurysm, Dissecting|Aortic Aneurysm, Thoracic|Hypertension,Chronic renal failure|Kidney Failure, Chronic,Coronary Disease|Coronary heart disease,Echocardiography,Kidney Failure, Chronic,Type 2 Diabetes| edema | rosiglitazone,asthma,cognitive ability,cognitive trait,kidney failure,lung cancer,metabolic syndrome,
HSPB1	heat shock protein family B (small) member 1(HSPB1)	Homo sapiens	Charcot-Marie-Tooth disease,Diabetic Nephropathies|Diabetic Nephropathy,Multiple Sclerosis,lung cancer,
HGS	hepatocyte growth factor-regulated tyrosine kinase substrate(HGS)	Homo sapiens	HIV Infections|[X]Human immunodeficiency virus disease,
HP1BP3	heterochromatin protein 1 binding protein 3(HP1BP3)	Homo sapiens	Tobacco Use Disorder,longevity,
HNRNPLL	heterogeneous nuclear ribonucleoprotein L like(HNRNPLL)	Homo sapiens	Respiratory Function Tests,
HNRNPU	heterogeneous nuclear ribonucleoprotein U(HNRNPU)	Homo sapiens	Parkinson Disease,
HMGN4	high mobility group nucleosomal binding domain 4(HMGN4)	Homo sapiens	Hip,
HOXB2	homeobox B2(HOXB2)	Homo sapiens	ovarian cancer,primary tooth development ,
HCFC1R1	host cell factor C1 regulator 1(HCFC1R1)	Homo sapiens	Type 2 Diabetes| edema | rosiglitazone,
HADHA	hydroxyacyl-CoA dehydrogenase trifunctional multienzyme complex subunit alpha(HADHA)	Homo sapiens	Acquired Immunodeficiency Syndrome|Disease Progression,HELLP syndrome,HELLP syndrome; acute fatty liver of pregnancy,bladder cancer,chronic obstructive pulmonary disease,lung cancer,lung cancer ,obesity,preeclampsia,prostate cancer,
HPRT1	hypoxanthine phosphoribosyltransferase 1(HPRT1)	Homo sapiens	Arthritis, Rheumatoid|Osteoarthritis,Inflammatory bowel disease, NOS|Inflammatory Bowel Diseases|Leukopenia,Lesch-Nyhan syndrome,cytogenetic studies,inflammatory bowel disease ,lead toxicity,lung cancer,normal variation,smoking behavior,
ICOS	inducible T cell costimulator(ICOS)	Homo sapiens	Albuminuria,Arthritis, Rheumatoid|Liver Cirrhosis, Biliary,Arthritis, Rheumatoid|Rheumatoid Arthritis,Asthma|Bronchial Hyperreactivity|Hypersensitivity, Immediate,Asthma|Hypersensitivity, Immediate,Celiac Disease,Celiac Disease|Common Variable Immunodeficiency|IgA Deficiency,Celiac disease,Erythrocytes,Graft vs Host Disease|Recurrence,Hepatitis C|Remission, Spontaneous,Hypersensitivity,Leukemia, Lymphocytic, Chronic, B-Cell,Lipids,Lupus Erythematosus, Systemic|Systemic lupus erythematosus,Macular Degeneration,Rhinitis, Allergic, Seasonal,Socioeconomic Factors,Triglycerides,celiac disease,cervical cancer,cervical squamous cell carcinoma,cholangitis, sclerosing,diabetes, type 1 ,diabetes, type 1; celiac disease; myasthenia gravis,esophageal adenocarcinoma,hyper-IgM syndrome,kidney transplantation,lymphoma, non-Hodgkin,melanoma,multiple sclerosis,periodontitis,
IVNS1ABP	influenza virus NS1A binding protein(IVNS1ABP)	Homo sapiens	C-Reactive Protein,Lipoproteins, VLDL,Respiratory Function Tests,Tobacco Use Disorder,Urinalysis,obesity,
IKBKG	inhibitor of nuclear factor kappa B kinase regulatory subunit gamma(IKBKG)	Homo sapiens	Bone Mineral Density,HIV Infections|[X]Human immunodeficiency virus disease,atherosclerosis,
PPA1	inorganic pyrophosphatase 1(PPA1)	Homo sapiens	Tumor Necrosis Factor-alpha,
IMPDH2	inosine monophosphate dehydrogenase 2(IMPDH2)	Homo sapiens	Arthritis, Rheumatoid|Rheumatoid Arthritis,Chronic renal failure|Kidney Failure, Chronic,Kidney Failure, Chronic,acute rejection after kidney transplantation,mycophenolate mofetil,normal variation,schizophrenia,
INPP5D	inositol polyphosphate-5-phosphatase D(INPP5D)	Homo sapiens	Hepatitis C|Remission, Spontaneous,Tobacco Use Disorder,Type 2 Diabetes| edema | rosiglitazone,
ITM2C	integral membrane protein 2C(ITM2C)	Homo sapiens	Apoplexy|Cerebral Hemorrhage|Cerebral Hemorrhages|Intracranial Hemorrhages|Stroke|Subarachnoid Hemorrhage,hypertension,
ILK	integrin linked kinase(ILK)	Homo sapiens	plasma HDL cholesterol (HDL-C) levels,
ITGAE	integrin subunit alpha E(ITGAE)	Homo sapiens	ADHD | attention-deficit hyperactivity disorder,Attention Deficit Disorder with Hyperactivity,Brain Ischemia|Cardiovascular Diseases|Coronary Disease|Stroke,Coronary Disease|Coronary heart disease|Myocardial Infarction,Dengue Hemorrhagic Fever,Graves Ophthalmopathy|Thyroid associated opthalmopathies,Leukemia, Lymphocytic, Chronic, B-Cell,Sarcoidosis,Tobacco Use Disorder,
ITGAL	integrin subunit alpha L(ITGAL)	Homo sapiens	Parkinson Disease,Type 2 Diabetes| edema | rosiglitazone,gastric ulcer,inflammatory bowel disease,
ITGB1BP1	integrin subunit beta 1 binding protein 1(ITGB1BP1)	Homo sapiens	breast cancer   ,
ITGB2	integrin subunit beta 2(ITGB2)	Homo sapiens	Alcoholism,Asthma|Bronchiolitis, Viral|Respiratory Syncytial Virus Infections,Birth Weight|Leukemia|Leukemia, Myeloid, Acute|Precursor Cell Lymphoblastic Leukemia-Lymphoma,Brain Ischemia|Recurrence|Stroke,Bronchiolitis, Viral|Respiratory Syncytial Virus Infections,Enterocolitis|Hirschsprung Disease,Glioblastoma|Glioma,Glomerulonephritis, IGA,Kidney Failure, Chronic,Lymphoma, Non-Hodgkin,MPO-ANCA+ vasculitis,Macular Degeneration,Meningeal Neoplasms|meningioma,Narcolepsy,Neoplasms,Obesity,Parkinson's disease    ,Stroke,Type 2 Diabetes| edema | rosiglitazone,anti-myeloperoxidase subtypes of ANCA-associated systemic vasculitides,breast cancer   ,cerebral infarct, atherothrombotic,leukocyte adhesion deficiency,metabolic syndrome,reduced risk of restenosis after coronary stenting,respiratory syncytial virus bronchiolitis,restenosis,retinopathy, diabetic,stroke,thyroid cancer,
ICAM3	intercellular adhesion molecule 3(ICAM3)	Homo sapiens	Arthritis, Rheumatoid|,Birth Weight|Leukemia|Leukemia, Myeloid, Acute|Precursor Cell Lymphoblastic Leukemia-Lymphoma,Chronic renal failure|Kidney Failure, Chronic,Hepatitis C|Remission, Spontaneous,Meningeal Neoplasms|meningioma,Severe Acute Respiratory Syndrome,Type 2 Diabetes| edema | rosiglitazone,lactate dehydrogenase severe acute respiratory syndrome,
IFI16	interferon gamma inducible protein 16(IFI16)	Homo sapiens	Autoimmune Diseases,Blood Proteins,Lupus Erythematosus, Systemic|Systemic lupus erythematosus,Tobacco Use Disorder,ovarian cancer,
IFITM1	interferon induced transmembrane protein 1(IFITM1)	Homo sapiens	Hepatitis C|Remission, Spontaneous,ovarian cancer,
IRF1	interferon regulatory factor 1(IRF1)	Homo sapiens	Asthma,Asthma|Bronchial Hyperreactivity,Asthma|Bronchial Hyperreactivity|Hypersensitivity, Immediate,Asthma|Bronchiolitis, Viral|Respiratory Syncytial Virus Infections,Behcet Syndrome|Thrombosis,Bronchiolitis, Viral|Respiratory Syncytial Virus Infections,C-Reactive Protein,Celiac Disease,Crohn's disease,Dengue Hemorrhagic Fever,Eosinophils,Graves' disease,Hepatitis B, Chronic|Viremia,Hepatitis C, Chronic|Multiple Sclerosis,Hypersensitivity,Malaria,Malaria, Falciparum,Multiple Sclerosis,Platelet Count,Tuberculosis,Tuberculosis, Pulmonary,arthritis,asthma,asthma; atopy,bladder cancer,celiac disease,cervical cancer,cervical intraepithelial neoplasia grade 3,chronic obstructive pulmonary disease,circulating fibrinogen levels,diabetes, type 1,fibrinogen,graft-versus-host disease,hepatitis B,hepatitis C,hepatitis C, chronic,juvenile arthritis,lung cancer,lung cancer ,normal variation,respiratory syncytial virus bronchiolitis,subacure sclerosing panencephalitis,
IRF2BP2	interferon regulatory factor 2 binding protein 2(IRF2BP2)	Homo sapiens	Arrhythmias, Cardiac,Cholesterol,Cholesterol, HDL,Cholesterol, LDL,Glucose,
IRF7	interferon regulatory factor 7(IRF7)	Homo sapiens	Autoimmune Diseases|Lupus Erythematosus, Systemic|Systemic lupus erythematosus,Dengue Hemorrhagic Fever,Diabetes Mellitus,Hepatitis C, Chronic|Liver Cirrhosis,Hepatitis C, Chronic|Neutropenia|Thrombocytopenia,Hepatitis C|Remission, Spontaneous,Hypertrophy, Left Ventricular,Lupus Erythematosus, Systemic,Lupus Erythematosus, Systemic|Systemic lupus erythematosus,ovarian cancer,
IL10RA	interleukin 10 receptor subunit alpha(IL10RA)	Homo sapiens	Acquired Immunodeficiency Syndrome|AIDS-Related Opportunistic Infections|Cytomegalovirus Retinitis,Arthritis, Rheumatoid|Lupus Erythematosus, Systemic,Asthma|Bronchiolitis, Viral|Respiratory Syncytial Virus Infections,Body Height,Bronchiolitis, Viral|Respiratory Syncytial Virus Infections,Celiac Disease,Central Nervous System Neoplasms|Central Nervous System Tumors|HIV Infections|Lymphoma, AIDS-Related|[X]Human immunodeficiency virus disease,Chorioamnionitis|Fetal Membranes, Premature Rupture|Infection of amniotic sac and membranes,Chorioamnionitis|Fetal Membranes, Premature Rupture|Infection of amniotic sac and membranes|Obstetric Labor, Premature|Pre-Eclampsia|Premature Birth,Chronic renal failure|Kidney Failure, Chronic,Colitis, Ulcerative|,Connective Tissue Diseases|Fetal Diseases|Inflammation|Musculoskeletal Diseases|Pregnancy Complications, Hematologic|Premature Birth|Skin Diseases,Dengue Hemorrhagic Fever,Graft vs Host Disease|Hematologic Neoplasms,H. pylori infection,HIV,HIV Infections|[X]Human immunodeficiency virus disease,Hepatitis B,Hepatitis C,Hepatitis C|Remission, Spontaneous,Hodgkin Disease|Leukemia, Lymphocytic, Chronic, B-Cell|Lymphoproliferative Disorders|Waldenstrom Macroglobulinemia,Hyperparathyroidism, Secondary,Hypersensitivity,Infection|Inflammation|Premature Birth,Inflammation|Premature Birth,Lupus Erythematosus, Systemic|Systemic lupus erythematosus,Lymphoma, Large B-Cell, Diffuse,Lymphoproliferative Disorders,Multiple Myeloma,Premature Birth|Vaginosis, Bacterial,Sepsis|Systemic infection,Tourette Syndrome,Tunica Media,Type 2 Diabetes| edema | rosiglitazone,benzene haematotoxicity,bladder cancer,cervical intraepithelial neoplasia grade 3,chronic obstructive pulmonary disease,cirrhosis,esophageal adenocarcinoma,hepatitis C,lung cancer,lung cancer ,lung function,lymphoma,measles vaccine immunity,obesity,patent ductus arteriosus,respiratory syncytial virus bronchiolitis,schizophrenia,vascular disease,
IL2RB	interleukin 2 receptor subunit beta(IL2RB)	Homo sapiens	Arthritis, Rheumatoid,Arthritis, Rheumatoid|Rheumatoid Arthritis,Asthma,Asthma|Bronchial Hyperreactivity,Asthma|Bronchiolitis, Viral|Respiratory Syncytial Virus Infections,Bronchiolitis, Viral|Respiratory Syncytial Virus Infections,Celiac Disease|,Chagas Disease,Chronic renal failure|Kidney Failure, Chronic,Connective Tissue Diseases|Fetal Diseases|Inflammation|Musculoskeletal Diseases|Pregnancy Complications, Hematologic|Premature Birth|Skin Diseases,Diabetes Mellitus, Type 1,Endometriosis,Hyperparathyroidism, Secondary,Infection|Inflammation|Premature Birth,Inflammation|Premature Birth,Measles|Mumps|Rubella,Myasthenia Gravis,Parkinson Disease,Premature Birth,Tobacco Use Disorder,Type 2 Diabetes| edema | rosiglitazone,Wegener's granulomatosis,asthma,hepatitis C,hepatocellular carcinoma,inflammatory bowel disease ,leishmaniasis,lung cancer,lung cancer ,measles vaccine immunity,multiple sclerosis,prostate cancer,respiratory syncytial virus bronchiolitis,schizophrenia,schizophrenia; schizoaffective disorder; bipolar disorder,
IL2RG	interleukin 2 receptor subunit gamma(IL2RG)	Homo sapiens	Asthma|Bronchiolitis, Viral|Respiratory Syncytial Virus Infections,Bronchiolitis, Viral|Respiratory Syncytial Virus Infections,Immunologic Deficiency Syndromes|Severe Combined Immunodeficiency,Lymphopenia|SCID|Severe Combined Immunodeficiency,X-linked severe combined immunodeficiency,respiratory syncytial virus bronchiolitis,
IL27RA	interleukin 27 receptor subunit alpha(IL27RA)	Homo sapiens	Asthma|Bronchiolitis, Viral|Respiratory Syncytial Virus Infections,Bronchiolitis, Viral|Respiratory Syncytial Virus Infections,respiratory syncytial virus bronchiolitis,
ILF3	interleukin enhancer binding factor 3(ILF3)	Homo sapiens	Type 2 Diabetes| edema | rosiglitazone,
ISOC1	isochorismatase domain containing 1(ISOC1)	Homo sapiens	Albumins,Body Composition,Cholesterol,Fibrinogen,
IDH3B	isocitrate dehydrogenase (NAD(+)) 3 non-catalytic subunit beta(IDH3B)	Homo sapiens	Acquired Immunodeficiency Syndrome|Disease Progression,
JARID2	jumonji and AT-rich interaction domain containing 2(JARID2)	Homo sapiens	Behcet Syndrome,Neuroblastoma,multiple sclerosis (severity),schizophrenia,
KPNA4	karyopherin subunit alpha 4(KPNA4)	Homo sapiens	Blood Coagulation Factors,Cholesterol, HDL,
KPNB1	karyopherin subunit beta 1(KPNB1)	Homo sapiens	breast cancer   ,
LDHB	lactate dehydrogenase B(LDHB)	Homo sapiens	Acquired Immunodeficiency Syndrome|Disease Progression,panic disorder,
LBR	lamin B receptor(LBR)	Homo sapiens	Type 2 Diabetes| edema | rosiglitazone,
LMNB1	lamin B1(LMNB1)	Homo sapiens	C-Reactive Protein,Multiple Sclerosis,Type 2 Diabetes| edema | rosiglitazone,
LMAN1	lectin, mannose binding 1(LMAN1)	Homo sapiens	Birth Weight|Leukemia|Leukemia, Myeloid, Acute|Precursor Cell Lymphoblastic Leukemia-Lymphoma,Cardiovascular Diseases|,Charcot-Marie-Tooth disease,Factor V Deficiency|Hemophilia A,Heart Diseases,Meningeal Neoplasms|meningioma,Sleep,Type 2 Diabetes| edema | rosiglitazone,atherosclerosis, coronary,coronary artery disease,inflammatory bowel disease,liver disease, chronic,pneumococcal infection,sepsis; systemic inflammatory response syndrome,systemic lupus erythematosus,
LEPROTL1	leptin receptor overlapping transcript like 1(LEPROTL1)	Homo sapiens	Obesity|POF - Premature ovarian failure|POLYCYSTIC OVARIAN SYNDROME|Polycystic Ovary Syndrome|Primary Ovarian Insufficiency|Puberty, Delayed|Puberty, Precocious|Thrombophilia|Tobacco Use Disorder,obesity,
LUZP1	leucine zipper protein 1(LUZP1)	Homo sapiens	Myocardial Infarction,
LNPEP	leucyl and cystinyl aminopeptidase(LNPEP)	Homo sapiens	Hypertension|Pre-Eclampsia|Pregnancy Complications,
LTA4H	leukotriene A4 hydrolase(LTA4H)	Homo sapiens	Asthma,Asthma|Hypersensitivity,Atherosclerosis,Atopic asthma,Body Height,Brain Ischemia|Stroke,Carotid Artery Diseases,Disease Models, Animal|Fish Diseases|Leprosy|Tuberculosis,Myocardial Infarction,Type 2 Diabetes| edema | rosiglitazone,Varicose Veins,asthma,depression,metabolic syndrome,myocardial infarct,
LPXN	leupaxin(LPXN)	Homo sapiens	Type 2 Diabetes| edema | rosiglitazone,
LRIF1	ligand dependent nuclear receptor interacting factor 1(LRIF1)	Homo sapiens	HIV Infections|[X]Human immunodeficiency virus disease,
LAT	linker for activation of T cells(LAT)	Homo sapiens	drug-related genes ,
LITAF	lipopolysaccharide induced TNF factor(LITAF)	Homo sapiens	Arrhythmias, Cardiac|Death, Sudden, Cardiac|,Charcot-Marie-Tooth disease,Coronary Disease,Electrocardiography,Multiple Sclerosis,QT interval,bladder cancer,chronic obstructive pulmonary disease,lung cancer,lung cancer ,
LCP1	lymphocyte cytosolic protein 1(LCP1)	Homo sapiens	diabetes, type 2,
KAT6B	lysine acetyltransferase 6B(KAT6B)	Homo sapiens	Alzheimer's disease   ,Blood Coagulation Factors,Cardiovascular Diseases,Natriuretic Peptide, Brain,Tobacco Use Disorder,
KDM2B	lysine demethylase 2B(KDM2B)	Homo sapiens	Tobacco Use Disorder,
LPCAT3	lysophosphatidylcholine acyltransferase 3(LPCAT3)	Homo sapiens	hypertension,
LAMP2	lysosomal associated membrane protein 2(LAMP2)	Homo sapiens	Cardiomegaly|Cardiomyopathy, Dilated|,Fibrinogen,Type 2 Diabetes| edema | rosiglitazone,
MAEA	macrophage erythroblast attacher, E3 ubiquitin ligase(MAEA)	Homo sapiens	Diabetes Mellitus, Type 2,
MFSD14A	major facilitator superfamily domain containing 14A(MFSD14A)	Homo sapiens	Alzheimer Disease,
HLA-E	major histocompatibility complex, class I, E(HLA-E)	Homo sapiens	Abortion, Spontaneous,Anemia, Sickle Cell|Bacterial Infections|Sickle cell anemia,Behcet Syndrome,Behcet's disease,Chorioamnionitis|Fetal Membranes, Premature Rupture|Infection of amniotic sac and membranes,Chorioamnionitis|Fetal Membranes, Premature Rupture|Infection of amniotic sac and membranes|Obstetric Labor, Premature|Pre-Eclampsia|Premature Birth,Coronary Aneurysm|Mucocutaneous Lymph Node Syndrome,Graft vs Host Disease,HIV,HIV; nasopharyngeal cancer,Lupus Erythematosus, Systemic,Psoriasis,ankylosing spondylitis,bone marrow transplantation,cirrhosis, biliary primary; diabetes, gestational,diabetes, gestational,graft-versus-host disease,nasopharyngeal cancer,pregnancy loss, recurrent,recurrent pregnancy loss,
MED28	mediator complex subunit 28(MED28)	Homo sapiens	HIV Infections|[X]Human immunodeficiency virus disease,
MAT2A	methionine adenosyltransferase 2A(MAT2A)	Homo sapiens	Breast Neoplasms|,Cleft Lip|Cleft Palate,Spinal Dysraphism,Type 2 Diabetes| edema | rosiglitazone,colorectal cancer,
METAP2	methionyl aminopeptidase 2(METAP2)	Homo sapiens	lung cancer,
MTHFD2	methylenetetrahydrofolate dehydrogenase (NADP+ dependent) 2, methenyltetrahydrofolate cyclohydrolase(MTHFD2)	Homo sapiens	Acquired Immunodeficiency Syndrome|Disease Progression,Cleft Lip|Cleft Palate,Heart Defects, Congenital|Spinal Dysraphism,Lymphoma, Follicular|Lymphoma, Large B-Cell, Diffuse,Spinal Dysraphism,bladder cancer,chronic obstructive pulmonary disease,esophageal adenocarcinoma,lung cancer,lung cancer ,
MVD	mevalonate diphosphate decarboxylase(MVD)	Homo sapiens	Type 2 Diabetes| edema | rosiglitazone,plasma HDL cholesterol (HDL-C) levels,
MAPRE2	microtubule associated protein RP/EB family member 2(MAPRE2)	Homo sapiens	Cholesterol, LDL,Occipital Lobe,Osteoporosis,Parkinson Disease,Tobacco Use Disorder,colorectal cancer,
MIEN1	migration and invasion enhancer 1(MIEN1)	Homo sapiens	breast cancer,breast cancer   ,
MUL1	mitochondrial E3 ubiquitin protein ligase 1(MUL1)	Homo sapiens	Acquired Immunodeficiency Syndrome|Disease Progression,
MRPL27	mitochondrial ribosomal protein L27(MRPL27)	Homo sapiens	Acquired Immunodeficiency Syndrome|Disease Progression,
MRPL43	mitochondrial ribosomal protein L43(MRPL43)	Homo sapiens	Acquired Immunodeficiency Syndrome|Disease Progression,Alzheimer's disease   ,
MRPS16	mitochondrial ribosomal protein S16(MRPS16)	Homo sapiens	Acquired Immunodeficiency Syndrome|Disease Progression,Alzheimer's disease   ,
MRPS23	mitochondrial ribosomal protein S23(MRPS23)	Homo sapiens	Acquired Immunodeficiency Syndrome|Disease Progression,Tobacco Use Disorder,
MRPS26	mitochondrial ribosomal protein S26(MRPS26)	Homo sapiens	Acquired Immunodeficiency Syndrome|Disease Progression,
MRPS7	mitochondrial ribosomal protein S7(MRPS7)	Homo sapiens	Acquired Immunodeficiency Syndrome|Disease Progression,
MAP2K3	mitogen-activated protein kinase kinase 3(MAP2K3)	Homo sapiens	Arthritis, Rheumatoid|Rheumatoid Arthritis,
MORF4L1	mortality factor 4 like 1(MORF4L1)	Homo sapiens	Heart Rate,Tobacco Use Disorder,
MBP	myelin basic protein(MBP)	Homo sapiens	Birth Weight|Leukemia|Leukemia, Myeloid, Acute|Precursor Cell Lymphoblastic Leukemia-Lymphoma,Blood Pressure,Cholesterol, LDL,Creatinine,Dermatitis, Atopic,Glucose,Hepatitis B,Hip,Meningeal Neoplasms|meningioma,Multiple Sclerosis,Myocardial Infarction,arthritis,breast cancer   ,chronic progressive multiple sclerosis.,diabetic nephropathy,host defence,multiple sclerosis,nephropathy, IgA,schizophrenia,systemic lupus erythematosus,tuberculosis,
MEF2D	myocyte enhancer factor 2D(MEF2D)	Homo sapiens	Apoplexy|Cerebral Hemorrhage|Cerebral Hemorrhages|Intracranial Hemorrhages|Stroke|Subarachnoid Hemorrhage,Bone Mineral Density,Diabetes mellitus|Diabetes mellitus type II|Diabetes Mellitus, Type 2,Type 2 Diabetes| edema | rosiglitazone,hypertension,plasma HDL cholesterol (HDL-C) levels,
MYH9	myosin heavy chain 9(MYH9)	Homo sapiens	AIDS-Associated Nephropathy|Glomerulosclerosis, Focal Segmental|Hypertension,Albuminuria|Hypertension,Apoplexy|Cerebral Hemorrhage|Cerebral Hemorrhages|Intracranial Hemorrhages|Stroke|Subarachnoid Hemorrhage,Chronic renal failure|Diabetes mellitus|Endocrine System Diseases|Kidney Failure, Chronic|Urologic Diseases,Chronic renal failure|Kidney Failure, Chronic,Cleft Lip|Cleft Palate,Cleft Lip|Cleft Palate|,Deafness,Eye,Focal segmental glomsclerosis|Glomerulosclerosis, Focal Segmental,Glomerulonephritis|Hypertension|Kidney Failure, Chronic,Kidney Diseases,Lupus Nephritis|Nephritis SLE,Schizophrenia,Type 2 diabetes,hypertension,schizophrenia,thrombocytopenia,
NELFE	negative elongation factor complex member E(NELFE)	Homo sapiens	Acquired Immunodeficiency Syndrome|HIV Seropositivity,Choroid Diseases|Macular Degeneration|Peripheral Vascular Diseases,Chronic renal failure|Kidney Failure, Chronic,Diabetes Mellitus, Type 1|,Lupus Erythematosus, Systemic,Macular Degeneration,Multiple Sclerosis,
NPTN	neuroplastin(NPTN)	Homo sapiens	Schizophrenia,Waist-Hip Ratio,
NUFIP2	nuclear FMR1 interacting protein 2(NUFIP2)	Homo sapiens	Cholesterol, HDL,
NFATC2	nuclear factor of activated T cells 2(NFATC2)	Homo sapiens	Chronic renal failure|Kidney Failure, Chronic,Heart Failure,Narcolepsy,Socioeconomic Factors,Tobacco Use Disorder,Type 2 Diabetes| edema | rosiglitazone,depression,
NEAT1	nuclear paraspeckle assembly transcript 1(NEAT1)	Homo sapiens	Optic Disk,
NCOA4	nuclear receptor coactivator 4(NCOA4)	Homo sapiens	Acquired Immunodeficiency Syndrome|Disease Progression,Alzheimer's disease   ,plasma HDL cholesterol (HDL-C) levels,prostate cancer,thyroid cancer,
NUTF2	nuclear transport factor 2(NUTF2)	Homo sapiens	Cholesterol, HDL,Lipoproteins, HDL,
NOLC1	nucleolar and coiled-body phosphoprotein 1(NOLC1)	Homo sapiens	Alzheimer's disease   ,
NAP1L4	nucleosome assembly protein 1 like 4(NAP1L4)	Homo sapiens	Alcohol dependence ,Alcoholism,
NDEL1	nudE neurodevelopment protein 1 like 1(NDEL1)	Homo sapiens	schizophrenia,
OPTN	optineurin(OPTN)	Homo sapiens	Alzheimer's disease   ,Glaucoma, Open-Angle,Osteitis Deformans,Paget's disease,Retinal Diseases,Tobacco Use Disorder,Wide-angle glaucoma,glaucoma,glaucoma Leber's hereditary optic neuropathy optic atrophy, autosomal dominant,glaucoma, early-onset glaucoma, normal tension,glaucoma, normal-tension glaucoma, primary open-angle,glaucoma, primary open-angle,glaucoma, primary open-angle; glaucoma, normal tension,glaucoma; glaucoma, primary open-angle,normal tension glaucoma,open-angle glaucoma,primary open-angle glaucoma,
ODC1	ornithine decarboxylase 1(ODC1)	Homo sapiens	Adenoma|Colorectal Neoplasms,Adenoma|Colorectal Neoplasms|Neoplasm Recurrence, Local,Cardiovascular Diseases|Carotid Artery Diseases|Coronary Disease|Coronary heart disease|Coronary Restenosis,breast cancer   ,colorectal cancer,gastric disease,
OAZ1	ornithine decarboxylase antizyme 1(OAZ1)	Homo sapiens	Cardiovascular Diseases|Carotid Artery Diseases|Coronary Disease|Coronary heart disease|Coronary Restenosis,lupus erythematosus; lupus nephritis,
OSTF1	osteoclast stimulating factor 1(OSTF1)	Homo sapiens	Alzheimer Disease,Body Mass Index,Bone Mineral Density,Coronary Artery Disease,Echocardiography,Hyperparathyroidism, Secondary,Iron,Multiple Sclerosis,Nonalcoholic Fatty Liver Disease,
PPT1	palmitoyl-protein thioesterase 1(PPT1)	Homo sapiens	Neuronal Ceroid-Lipofuscinoses,Occipital Lobe,schizophrenia,
PANK2	pantothenate kinase 2(PANK2)	Homo sapiens	Acquired Immunodeficiency Syndrome|Disease Progression,Parkinson disease,Parkinson's disease,neurodegeneration with brain iron accumulation,
PPIB	peptidylprolyl isomerase B(PPIB)	Homo sapiens	HIV Infections|[X]Human immunodeficiency virus disease,
PPID	peptidylprolyl isomerase D(PPID)	Homo sapiens	Metabolism,Nonalcoholic Fatty Liver Disease,
PRF1	perforin 1(PRF1)	Homo sapiens	Alzheimer's disease   ,Arthritis, Juvenile Rheumatoid|Lymphohistiocytosis, Hemophagocytic,Asthma|Bronchiolitis, Viral|Respiratory Syncytial Virus Infections,Bronchiolitis, Viral|Respiratory Syncytial Virus Infections,Diabetes Mellitus, Type 1,Epstein-Barr Virus Infections|Lymphohistiocytosis, Hemophagocytic,HIV,HTLV-1 infection,Leukocyte Count,Lymphohistiocytosis, Hemophagocytic,Multiple Sclerosis,Precursor Cell Lymphoblastic Leukemia-Lymphoma,autoimmune lymphoproliferative syndrome,familial hemophagocytic lymphohistiocytosis,hemophagocytic lymphohistiocytosis,juvenile idiopathic arthritis,leukemia, acute lymphoblastic,lymphoma,multiple sclerosis,obesity (extreme),respiratory syncytial virus bronchiolitis,
PRDX3	peroxiredoxin 3(PRDX3)	Homo sapiens	Acquired Immunodeficiency Syndrome|Disease Progression,Aging/ Telomere Length,Alzheimer's disease   ,cognitive trait,
PMAIP1	phorbol-12-myristate-13-acetate-induced protein 1(PMAIP1)	Homo sapiens	Multiple Sclerosis,
PDCL3	phosducin like 3(PDCL3)	Homo sapiens	Creutzfeldt-Jakob Syndrome,Heart Rate,
PGD	phosphogluconate dehydrogenase(PGD)	Homo sapiens	Carcinoma, Hepatocellular|Hepatitis B, Chronic|LCC - Liver cell carcinoma|Liver neoplasms,Type 2 Diabetes| edema | rosiglitazone,
PLD3	phospholipase D family member 3(PLD3)	Homo sapiens	breast cancer,
GART	phosphoribosylglycinamide formyltransferase, phosphoribosylglycinamide synthetase, phosphoribosylaminoimidazole synthetase(GART)	Homo sapiens	Cleft Lip|Cleft Palate,Cleft Lip|Cleft Palate|Tooth Abnormalities,Macular Degeneration,Spinal Dysraphism,colorectal cancer,patent ductus arteriosus,
PCIF1	phosphorylated CTD interacting factor 1(PCIF1)	Homo sapiens	Cholesterol, HDL,Triglycerides,
PAFAH1B1	platelet activating factor acetylhydrolase 1b regulatory subunit 1(PAFAH1B1)	Homo sapiens	Alzheimer's disease,Asthma,Asthma. atopy,Asthma. atopy. spIgE.,Atherosclerosis|Cardiovascular Diseases,Atopy. asthma,Atopy. spIgE. total IgE. asthma. atopic asthma,C-reactive protein; kawasaki disease,Chorioamnionitis|Fetal Membranes, Premature Rupture|Infection of amniotic sac and membranes,Chorioamnionitis|Fetal Membranes, Premature Rupture|Infection of amniotic sac and membranes|Obstetric Labor, Premature|Pre-Eclampsia|Premature Birth,Classical Lissencephalies and Subcortical Band Heterotopias,Cleft Lip|Cleft Palate,Connective Tissue Diseases|Fetal Diseases|Inflammation|Musculoskeletal Diseases|Pregnancy Complications, Hematologic|Premature Birth|Skin Diseases,Infection|Inflammation|Premature Birth,Inflammation|Premature Birth,Premature Birth,Severe asthma,Total IgE,Total IgE. atopic asthma,Tunica Media,Type 2 Diabetes| edema | rosiglitazone,asthma,atherosclerosis, coronary,atherosclerosis, coronary myocardial infarct,bipolar disorder schizophrenia,cardiomyopathy,cerebral infarct,coronary heart disease,glaucoma, primary open-angle,graft occlusion, atherosclerotic,multiple sclerosis,schizophrenia,
PABPN1	poly(A) binding protein nuclear 1(PABPN1)	Homo sapiens	Muscular Dystrophy, oculopharyngeal,benzene haematotoxicity,
PTBP3	polypyrimidine tract binding protein 3(PTBP3)	Homo sapiens	Tobacco Use Disorder,
KCTD20	potassium channel tetramerization domain containing 20(KCTD20)	Homo sapiens	Tobacco Use Disorder,
PRPF40A	pre-mRNA processing factor 40 homolog A(PRPF40A)	Homo sapiens	Atrial Natriuretic Factor,CD40 Ligand,Follicle Stimulating Hormone,
PDCD2	programmed cell death 2(PDCD2)	Homo sapiens	Heart Rate,diabetes, type 1,
PDCD5	programmed cell death 5(PDCD5)	Homo sapiens	esophageal adenocarcinoma,leukemia, chronic myelogenous,lung cancer,lung cancer ,
PDCD6IP	programmed cell death 6 interacting protein(PDCD6IP)	Homo sapiens	Blood Pressure Determination,Body Fat Distribution,Cholesterol, LDL,Diabetes Mellitus, Type 2,Hemoglobin A, Glycosylated,Hip,Stroke,Tobacco Use Disorder,longevity,
PSMB1	proteasome 20S subunit beta 1(PSMB1)	Homo sapiens	Chronic renal failure|Kidney Failure, Chronic,diabetes, type 1,
PSMB8	proteasome 20S subunit beta 8(PSMB8)	Homo sapiens	Alveolitis, Extrinsic Allergic|Extrinsic allergic alveolitis,Alzheimers disease; juvenile arthritis,Asthma|Bronchiolitis, Viral|Respiratory Syncytial Virus Infections,Bronchiolitis, Viral|Respiratory Syncytial Virus Infections,Brucellosis,Diabetes Mellitus, Type 1,Glomerulonephritis, IGA,Hepatitis C|Remission, Spontaneous,Hypertension,JRA,Lupus Erythematosus, Systemic,Papillomavirus Infections|Uterine Cervical Neoplasms,Spondylitis, Ankylosing,Type 2 Diabetes| edema | rosiglitazone,Uterine Cervical Neoplasms,Vitiligo,acute coronary syndrome,ankylosing spondylitis,arthritis, juvenile,dermatitis, atopic,diabetes, type 1,hepatitis B,interferon response,juvenile arthritis,liver disease,multiple sclerosis,psoriasis,respiratory syncytial virus bronchiolitis,sarcoidosis.,spondyloarthropathies,
PSMB9	proteasome 20S subunit beta 9(PSMB9)	Homo sapiens	Alveolitis, Extrinsic Allergic|Extrinsic allergic alveolitis,Alzheimer's Disease,Alzheimers disease; juvenile arthritis,Brucellosis,Forced Vital Capacity,Graves disease,Hypertension,Lupus Erythematosus, Systemic,Myocardial Infarction,Papillomavirus Infections|Uterine Cervical Neoplasms,Spondylitis, Ankylosing,Type 2 Diabetes| edema | rosiglitazone,Uterine Cervical Neoplasms,acute coronary syndrome,ankylosing spondylitis,colorectal cancer,dermatitis, atopic,diabetes, type 1,hepatitis B,interferon response,juvenile arthritis,malaria; hypoglycemia; hyperparasitemia,multiple sclerosis,multiple sclerosis; IgA nephropathy,psoriasis,rheumatoid arthritis,spondyloarthropathies,
PSMC1	proteasome 26S subunit, ATPase 1(PSMC1)	Homo sapiens	Tobacco Use Disorder,
PSMD14	proteasome 26S subunit, non-ATPase 14(PSMD14)	Homo sapiens	Coronary Artery Disease,
PSMD3	proteasome 26S subunit, non-ATPase 3(PSMD3)	Homo sapiens	Cell Adhesion Molecules,Leukocyte Count,Neutrophils,neutrophil count ,
PSMD9	proteasome 26S subunit, non-ATPase 9(PSMD9)	Homo sapiens	depression,diabetes, type 2,
POMP	proteasome maturation protein(POMP)	Homo sapiens	Tobacco Use Disorder,
PRKCH	protein kinase C eta(PRKCH)	Homo sapiens	Arthritis, Rheumatoid,Atherosclerosis|Brain Infarction|Hypertension,Brain Infarction,Brain Infarction|,Brain Ischemia|Cerebral Hemorrhage|Stroke,Calcium-Binding Proteins,Creatinine,Exercise Test,Gastritis, Atrophic|Helicobacter Infections|Stomach Neoplasms,Glomerular Filtration Rate,Narcolepsy,Platelet Aggregation,Stroke,Tobacco Use Disorder,depression,rheumatoid arthritis,
PRKCQ	protein kinase C theta(PRKCQ)	Homo sapiens	Alzheimer Disease,Alzheimer's disease   ,Apoplexy|Cerebral Hemorrhage|Cerebral Hemorrhages|Intracranial Hemorrhages|Stroke|Subarachnoid Hemorrhage,Arthritis, Juvenile Rheumatoid|Arthritis, Rheumatoid|Chronic Childhood Arthritis|Rheumatoid Arthritis,Arthritis, Rheumatoid|,Arthritis, Rheumatoid|Rheumatoid Arthritis,Blood Proteins,Body Height,Body Weight,Celiac Disease|,Cell Adhesion Molecules,Cholesterol, LDL,Chronic renal failure|Kidney Failure, Chronic,Coronary Artery Disease,Diabetes Mellitus, Type 1,Exercise Test,Glucose,Hip,Hypertension,Iron,Jaw Abnormalities,Leprosy,Lipids,Mental Competency,Myocardial Infarction,Narcolepsy,Stroke,Tobacco Use Disorder,Type 2 Diabetes| edema | rosiglitazone,Type 2 diabetes|reduced prostate cancer risk,Wegener's granulomatosis,diabetes, type 1 ,hypertension,rheumatoid arthritis,type 1 diabetes,
PRKAR2A	protein kinase cAMP-dependent type II regulatory subunit alpha(PRKAR2A)	Homo sapiens	schizophrenia,
PPP1CB	protein phosphatase 1 catalytic subunit beta(PPP1CB)	Homo sapiens	breast cancer   ,
PPP1R11	protein phosphatase 1 regulatory inhibitor subunit 11(PPP1R11)	Homo sapiens	Lupus Erythematosus, Systemic,Multiple Sclerosis,
PPP2CA	protein phosphatase 2 catalytic subunit alpha(PPP2CA)	Homo sapiens	Narcolepsy,
PPP2R2A	protein phosphatase 2 regulatory subunit Balpha(PPP2R2A)	Homo sapiens	HIV Infections|[X]Human immunodeficiency virus disease,Hypertension,breast cancer   ,
PPP2R1A	protein phosphatase 2 scaffold subunit Aalpha(PPP2R1A)	Homo sapiens	breast cancer   ,
PPP3CC	protein phosphatase 3 catalytic subunit gamma(PPP3CC)	Homo sapiens	Amphetamine-Related Disorders|Psychoses, Substance-Induced,HIV-1,Psychiatric Disorders,Schizophrenia,schizophrenia,
PPP4R3B	protein phosphatase 4 regulatory subunit 3B(PPP4R3B)	Homo sapiens	Blood Pressure,Body Weight,Metabolic Syndrome X,
PPM1G	protein phosphatase, Mg2+/Mn2+ dependent 1G(PPM1G)	Homo sapiens	Alcoholism,
PPM1K	protein phosphatase, Mg2+/Mn2+ dependent 1K(PPM1K)	Homo sapiens	Acquired Immunodeficiency Syndrome|Disease Progression,Amyotrophic Lateral Sclerosis|,Conduct Disorder,Conduct disorder (interaction),Metabolism,Stroke,
PTPN1	protein tyrosine phosphatase non-receptor type 1(PTPN1)	Homo sapiens	Alzheimer's disease   ,Atrophy|Helicobacter Infections|Stomach Neoplasms,Cardiomyopathy, Hypertrophic|Hypertrophic Cardiomyopathy|Noonan Syndrome|Pulmonary Valve Stenosis|Syndrome|Turner's phenotype, karyotype normal,Chronic renal failure|Kidney Failure, Chronic,Diabetes mellitus|Diabetes mellitus type II|Diabetes Mellitus, Type 2,Insulin Resistance|Metabolic Syndrome X,Kidney Failure, Chronic,Lymphoma, Non-Hodgkin,Obesity,Obesity, Morbid,Type 2 diabetes,anthropometric parameters diabetes, type 2 insulin,atherosclerosis,atherosclerosis, diabetic,body mass; diabetes, type 2; hypertension; albuminuria; glycohemoglobin A1,diabetes or impaired glucose tolerance,diabetes, type 2,diabetes, type 2 glucose insulin obesity,diabetes, type 2 obesity,diabetes, type 2; glucose tolerance,glucose tolerance; insulin,glucose tolerance; insulin; body fat,hypertension,insulin; body fat; metabolic syndrome,obesity,ovarian cancer,plasma HDL cholesterol (HDL-C) levels,type 1 diabetes,
PTPN2	protein tyrosine phosphatase non-receptor type 2(PTPN2)	Homo sapiens	Addison Disease|,Anti-Neutrophil Cytoplasmic Antibody-Associated Vasculitis|,Arthritis, Rheumatoid,Arthritis, Rheumatoid|,Arthritis|Arthritis, Juvenile Rheumatoid|Arthritis, Rheumatoid|Autoimmune Diseases|Lupus Erythematosus, Systemic,Autoimmune Diseases,Autoimmune Diseases|Lupus Erythematosus, Systemic|Systemic lupus erythematosus,C-Reactive Protein,Celiac Disease,Celiac Disease|,Celiac disease,Colitis, Ulcerative|Crohn Disease|,Colonic Diseases|Crohn Disease|Ileal Diseases,Crohn Disease|Crohn's disease,Crohn Disease|Crohn's disease|Inflammatory bowel disease, NOS|Inflammatory Bowel Diseases,Crohn Disease|Rectal Fistula,Crohn's,Crohn's disease,Diabetes Mellitus, Insulin-Dependent|Diabetes Mellitus, Type 1|Disease Progression,Diabetes Mellitus, Type 1,Magnesium,Tobacco Use Disorder,Type 1 diabetes,Type 2 diabetes|reduced prostate cancer risk,diabetes, type 1 ,type 1 diabetes,ulcerative colitis,
PUM2	pumilio RNA binding family member 2(PUM2)	Homo sapiens	Attention Deficit Disorder with Hyperactivity,azoospermia,
PNP	purine nucleoside phosphorylase(PNP)	Homo sapiens	Alzheimer's disease cognitive function,
PHTF2	putative homeodomain transcription factor 2(PHTF2)	Homo sapiens	Behcet Syndrome,Body Mass Index,Cholesterol,Cholesterol, LDL,Hematocrit,Hemoglobins,Insulin,Lipids,
PYHIN1	pyrin and HIN domain family member 1(PYHIN1)	Homo sapiens	Asthma,Glucose,Lupus Erythematosus, Systemic|Systemic lupus erythematosus,Tobacco Use Disorder,
ROMO1	reactive oxygen species modulator 1(ROMO1)	Homo sapiens	Acquired Immunodeficiency Syndrome|Disease Progression,
RGS1	regulator of G protein signaling 1(RGS1)	Homo sapiens	Arthritis, Juvenile Rheumatoid|Autoimmune Diseases|Celiac Disease|Chronic Childhood Arthritis|Diabetes Mellitus, Insulin-Dependent|Diabetes Mellitus, Type 1,Bulimia,Carcinoma, Squamous Cell|Head and Neck Neoplasms|Neoplasm Recurrence, Local|Neoplasms, Second Primary|Squamous cell carcinoma,Celiac Disease|,Celiac disease,Multiple Sclerosis,Type 2 Diabetes| edema | rosiglitazone,coeliac disease,diabetes, type 1 ,multiple sclerosis,
RGS10	regulator of G protein signaling 10(RGS10)	Homo sapiens	Alzheimer's disease   ,Bulimia,Carcinoma, Squamous Cell|Head and Neck Neoplasms|Neoplasm Recurrence, Local|Neoplasms, Second Primary|Squamous cell carcinoma,schizophrenia,
RGS2	regulator of G protein signaling 2(RGS2)	Homo sapiens	Autonomic Nervous System Diseases|Syncope, Vasovagal,Blood Coagulation Factors,Blood Pressure,Bulimia,C-Reactive Protein,Carcinoma, Squamous Cell|Head and Neck Neoplasms|Neoplasm Recurrence, Local|Neoplasms, Second Primary|Squamous cell carcinoma,Cholesterol, HDL,Hip,Hyperlipidemias|Hypertension,Hypertension,Marijuana Abuse|Psychoses, Substance-Induced,Multiple Sclerosis,Parkinson Disease,Parkinson's disease    ,Postmortem Changes,Receptors, Tumor Necrosis Factor,Schizophrenia,Syncope,Type 2 Diabetes| edema | rosiglitazone,anxiety,atherosclerosis,bladder cancer,esophageal adenocarcinoma,extrapyramidal side effects,hypertension,lung cancer,metabolic syndrome,ovarian cancer,panic disorder,schizophrenia,suicidal ideation,
RPA1	replication protein A1(RPA1)	Homo sapiens	Coronary Disease,Forced Expiratory Volume,Head and Neck Neoplasms|Neoplasm Recurrence, Local|Neoplasms, Second Primary,Leukemia, Myeloid, Chronic-Phase,Stroke,bladder cancer,breast cancer,coronary spastic angina.,head and neck cancer lung cancer,multiple sclerosis,schizophrenia,
RPA3	replication protein A3(RPA3)	Homo sapiens	Alcoholism,Breath Tests,Cholesterol,Cholesterol, LDL,Leukemia, Myeloid, Chronic-Phase,Myocardial Infarction,bladder cancer,breast cancer,head and neck cancer lung cancer,multiple sclerosis,
RTN4	reticulon 4(RTN4)	Homo sapiens	Cardiomyopathy, Dilated,Cholesterol, HDL,Hypertension,Lipids,Tobacco Use Disorder,Triglycerides,obesity (extreme),schizophrenia,schizophrenia; bipolar disorder,
RNASET2	ribonuclease T2(RNASET2)	Homo sapiens	Crohn Disease|Crohn's disease,Graves Disease,Vitiligo,
RNF114	ring finger protein 114(RNF114)	Homo sapiens	Arthritis, Psoriatic|Psoriasis|Psoriatic arthropathy,Parkinson Disease,Parkinson's disease    ,Psoriasis,
RNF115	ring finger protein 115(RNF115)	Homo sapiens	Tobacco Use Disorder,
RNF145	ring finger protein 145(RNF145)	Homo sapiens	Platelet Count,
RNF149	ring finger protein 149(RNF149)	Homo sapiens	Glucose,Pancreatic Neoplasms,
RNF19A	ring finger protein 19A, RBR E3 ubiquitin protein ligase(RNF19A)	Homo sapiens	Angiography,Body Height,Echocardiography,Heart Function Tests,Sleep,
RNF41	ring finger protein 41(RNF41)	Homo sapiens	Parkinson's disease    ,
SLFN12L	schlafen family member 12 like(SLFN12L)	Homo sapiens	Diabetes Mellitus, Insulin-Dependent|Diabetes Mellitus, Type 1|HIV Infections|[X]Human immunodeficiency virus disease,Tobacco Use Disorder,
SCAMP2	secretory carrier membrane protein 2(SCAMP2)	Homo sapiens	Hemoglobin A, Glycosylated,Hyperparathyroidism, Secondary,
SCAMP3	secretory carrier membrane protein 3(SCAMP3)	Homo sapiens	Crohn Disease,
SELPLG	selectin P ligand(SELPLG)	Homo sapiens	Atherosclerosis,Birth Weight|Leukemia|Leukemia, Myeloid, Acute|Precursor Cell Lymphoblastic Leukemia-Lymphoma,Conduct Disorder,Coronary Disease|Coronary heart disease,Hemorrhagic Disorders,Inflammation|Lymphoma, Non-Hodgkin|Lymphoma, Non-Hodgkin's,Leukemia, Lymphocytic, Chronic, B-Cell,Meningeal Neoplasms|meningioma,Myocardial Infarction|Ventricular Fibrillation,Thrombosis|Venous Thrombosis,Type 2 Diabetes| edema | rosiglitazone,antiphospholipid syndrome thrombosis,atherosclerosis, coronary,cerebrovascular disease,heart disease, ischemic,heart disease, ischemic stroke, ischemic,heart disease, ischemic; peripheral arterial disease,multiple sclerosis,myocardial infarct,
SRSF3	serine and arginine rich splicing factor 3(SRSF3)	Homo sapiens	Basophils,Electrocardiography,Glaucoma, Open-Angle,Heart Function Tests,
SRSF9	serine and arginine rich splicing factor 9(SRSF9)	Homo sapiens	Glaucoma, Open-Angle,
SERINC1	serine incorporator 1(SERINC1)	Homo sapiens	Cleft Lip|Cleft Palate|Tooth Abnormalities,Respiratory Function Tests,
SERINC5	serine incorporator 5(SERINC5)	Homo sapiens	Albumins,Arteries,Tobacco Use Disorder,
STK10	serine/threonine kinase 10(STK10)	Homo sapiens	Blood Cells,Cholesterol,Tobacco Use Disorder,
SHISA5	shisa family member 5(SHISA5)	Homo sapiens	schizophrenia,
SPN	sialophorin(SPN)	Homo sapiens	Chronic renal failure|Kidney Failure, Chronic,atopy,
STAT5B	signal transducer and activator of transcription 5B(STAT5B)	Homo sapiens	Birth Weight|Leukemia|Leukemia, Myeloid, Acute|Precursor Cell Lymphoblastic Leukemia-Lymphoma,Cleft Lip|Cleft Palate|Tooth Abnormalities,Meningeal Neoplasms|meningioma,Precursor Cell Lymphoblastic Leukemia-Lymphoma,Type 2 Diabetes| edema | rosiglitazone,breast cancer,height,myeloid leukemia,plasma HDL cholesterol (HDL-C) levels,
STAM	signal transducing adaptor molecule(STAM)	Homo sapiens	Alzheimer's disease   ,
SSBP1	single stranded DNA binding protein 1(SSBP1)	Homo sapiens	Acquired Immunodeficiency Syndrome|Disease Progression,Hemoglobin A, Glycosylated,
SMAP1	small ArfGAP 1(SMAP1)	Homo sapiens	CD40 Ligand,
SGTA	small glutamine rich tetratricopeptide repeat co-chaperone alpha(SGTA)	Homo sapiens	Insulin Resistance|Polycystic Ovary Syndrome,POLYCYSTIC OVARIAN SYNDROME|Polycystic Ovary Syndrome,
SLC16A3	solute carrier family 16 member 3(SLC16A3)	Homo sapiens	Type 2 Diabetes| edema | rosiglitazone,
SLC30A5	solute carrier family 30 member 5(SLC30A5)	Homo sapiens	lung cancer,prostate cancer,
SLC7A5	solute carrier family 7 member 5(SLC7A5)	Homo sapiens	Chronic renal failure|Kidney Failure, Chronic,melphalan pharmacokinetics melphalan side effects,
SNX5	sorting nexin 5(SNX5)	Homo sapiens	Alzheimer's disease   ,
SPTAN1	spectrin alpha, non-erythrocytic 1(SPTAN1)	Homo sapiens	HIV Infections|[X]Human immunodeficiency virus disease,Tobacco Use Disorder,Type 2 Diabetes| edema | rosiglitazone,
S1PR1	sphingosine-1-phosphate receptor 1(S1PR1)	Homo sapiens	Asthma,Brain Ischemia|Cardiovascular Diseases|Coronary Disease|Stroke,Coronary Disease|Coronary heart disease|Myocardial Infarction,Type 2 Diabetes| edema | rosiglitazone,atherosclerosis,
SF3A2	splicing factor 3a subunit 2(SF3A2)	Homo sapiens	Tobacco Use Disorder,
SF3B6	splicing factor 3b subunit 6(SF3B6)	Homo sapiens	benzene haematotoxicity,
STIP1	stress induced phosphoprotein 1(STIP1)	Homo sapiens	Attention Deficit Disorder with Hyperactivity,asthma,breast cancer,
SDF2L1	stromal cell derived factor 2 like 1(SDF2L1)	Homo sapiens	Heart Failure,
SDHC	succinate dehydrogenase complex subunit C(SDHC)	Homo sapiens	Acquired Immunodeficiency Syndrome|Disease Progression,Adrenal Gland Neoplasms|Adrenal Neoplasm|Paraganglioma|Pheochromocytoma,Adrenal Gland Neoplasms|Adrenal Neoplasm|Paraganglioma|Pheochromocytoma|Syndrome,Adrenal Gland Neoplasms|Carcinoma, Renal Cell|Kidney Neoplasms|Paraganglioma|Pheochromocytoma,Adrenal Gland Neoplasms|Multiple Endocrine Neoplasia Type 2a|Paraganglioma|Pheochromocytoma|von Hippel-Lindau Disease,Adrenal Gland Neoplasms|Paraganglioma|Pheochromocytoma,Adrenal Gland Neoplasms|Pheochromocytoma,H. pylori infection stomach cancer,Head and Neck Neoplasms|Paraganglioma,Paraganglioma,head and neck cancer,hypoxia,paragangliomas, head and neck,pheochromocytomas and paragangliomas,pheochtomocytomas,prostate cancer,spermatogenesis,thyroid cancer,
SNAP29	synaptosome associated protein 29(SNAP29)	Homo sapiens	Urogenital Abnormalities,schizophrenia,several psychiatric disorders,
SYTL3	synaptotagmin like 3(SYTL3)	Homo sapiens	Lipoprotein(a),Type 2 Diabetes| edema | rosiglitazone,
TTC3	tetratricopeptide repeat domain 3(TTC3)	Homo sapiens	Body Weight Changes,Eye Color,Tobacco Use Disorder,
TXN2	thioredoxin 2(TXN2)	Homo sapiens	Acquired Immunodeficiency Syndrome|Disease Progression,Aging/ Telomere Length,Head and Neck Neoplasms|Neoplasm Recurrence, Local|Neoplasms, Second Primary,Neural Tube Defects|Spinal Dysraphism,breast cancer,breast cancer   ,cognitive trait,
TMX1	thioredoxin related transmembrane protein 1(TMX1)	Homo sapiens	Bilirubin,Lupus Erythematosus, Systemic,Schizophrenia,
TMX3	thioredoxin related transmembrane protein 3(TMX3)	Homo sapiens	Celiac Disease|,
TYMP	thymidine phosphorylase(TYMP)	Homo sapiens	Amyotrophic Lateral Sclerosis|Anoxia|,Deafness|Diabetes Complications|Diabetes Mellitus|Intestinal Pseudo-Obstruction|Pancreatitis|Recurrence,Erythrocyte Indices,Intestinal Pseudo-Obstruction|Mitochondrial Diseases,Type 2 Diabetes| edema | rosiglitazone,encephalomyopathy,mean corpuscular volume,
TOR3A	torsin family 3 member A(TOR3A)	Homo sapiens	Erythrocyte Count,Tobacco Use Disorder,
TLK1	tousled like kinase 1(TLK1)	Homo sapiens	Lipoproteins,Menopause,Waist Circumference,Waist-Hip Ratio,
TCERG1	transcription elongation regulator 1(TCERG1)	Homo sapiens	Celiac Disease,
TADA3	transcriptional adaptor 3(TADA3)	Homo sapiens	Type 2 Diabetes| edema | rosiglitazone,
TKT	transketolase(TKT)	Homo sapiens	Heart Function Tests,Waist Circumference,
TSN	translin(TSN)	Homo sapiens	Attention Deficit Disorder with Hyperactivity,Audiometry, Pure-Tone,Cholesterol,Erectile Dysfunction,Erythrocyte Indices,Heart Rate,Life Expectancy,Maximal Midexpiratory Flow Rate,Respiratory Function Tests,Stroke,Triglycerides,Varicose Veins,Waist-Hip Ratio,monocyte chemoattractant protein 1 (66-77),
TRAM1	translocation associated membrane protein 1(TRAM1)	Homo sapiens	Birth Weight|Leukemia|Leukemia, Myeloid, Acute|Precursor Cell Lymphoblastic Leukemia-Lymphoma,Dengue Hemorrhagic Fever,Hepatitis C|Remission, Spontaneous,Meningeal Neoplasms|meningioma,
TMBIM6	transmembrane BAX inhibitor motif containing 6(TMBIM6)	Homo sapiens	Alzheimer's disease   ,Breath Tests,Type 2 Diabetes| edema | rosiglitazone,
TMEM11	transmembrane protein 11(TMEM11)	Homo sapiens	Acquired Immunodeficiency Syndrome|Disease Progression,
TMEM14C	transmembrane protein 14C(TMEM14C)	Homo sapiens	Acquired Immunodeficiency Syndrome|Disease Progression,
TMEM170A	transmembrane protein 170A(TMEM170A)	Homo sapiens	high-density lipoprotein cholesterol ,
TMEM70	transmembrane protein 70(TMEM70)	Homo sapiens	Acquired Immunodeficiency Syndrome|Disease Progression,Type 2 Diabetes| edema | rosiglitazone,
TMEM87A	transmembrane protein 87A(TMEM87A)	Homo sapiens	Stroke,
TNRC6B	trinucleotide repeat containing adaptor 6B(TNRC6B)	Homo sapiens	Body Height,Creatinine,E-Selectin,Echocardiography,Erythrocyte Indices,Fibromyoma,Insulin,Insulin Resistance,Prostatic Neoplasms,height,prostate cancer,
TRIM22	tripartite motif containing 22(TRIM22)	Homo sapiens	rubella vaccine,
TRIM4	tripartite motif containing 4(TRIM4)	Homo sapiens	Creatinine,Dehydroepiandrosterone Sulfate,Glomerular Filtration Rate,Metabolism,
TWF1	twinfilin actin binding protein 1(TWF1)	Homo sapiens	Birth Weight|Leukemia|Leukemia, Myeloid, Acute|Precursor Cell Lymphoblastic Leukemia-Lymphoma,Meningeal Neoplasms|meningioma,
YWHAE	tyrosine 3-monooxygenase/tryptophan 5-monooxygenase activation protein epsilon(YWHAE)	Homo sapiens	breast cancer,suicide,
YWHAQ	tyrosine 3-monooxygenase/tryptophan 5-monooxygenase activation protein theta(YWHAQ)	Homo sapiens	Cholesterol, LDL,Heart Rate,Respiratory Function Tests,breast cancer   ,
TDP2	tyrosyl-DNA phosphodiesterase 2(TDP2)	Homo sapiens	Hypertrophy, Left Ventricular,Narcolepsy,Polyradiculoneuropathy, Chronic Inflammatory Demyelinating,
UQCRC1	ubiquinol-cytochrome c reductase core protein 1(UQCRC1)	Homo sapiens	Acquired Immunodeficiency Syndrome|Disease Progression,
UBE2J2	ubiquitin conjugating enzyme E2 J2(UBE2J2)	Homo sapiens	Waist Circumference,
UBE2L3	ubiquitin conjugating enzyme E2 L3(UBE2L3)	Homo sapiens	Autoimmune Diseases|Lupus Erythematosus, Systemic|Systemic lupus erythematosus,Celiac disease,Cholesterol, HDL,Crohn Disease,Crohn Disease|Crohn's disease,Erythrocyte Indices,Lupus Erythematosus, Systemic,systemic lupus erythematosus,
UBL5	ubiquitin like 5(UBL5)	Homo sapiens	Autism,Body Weight|Obesity,metabolic syndrome,
UHRF2	ubiquitin like with PHD and ring finger domains 2(UHRF2)	Homo sapiens	C-Reactive Protein,Erythrocyte Count,Tobacco Use Disorder,
UBR2	ubiquitin protein ligase E3 component n-recognin 2(UBR2)	Homo sapiens	Tobacco Use Disorder,
USP15	ubiquitin specific peptidase 15(USP15)	Homo sapiens	Tobacco Use Disorder,
USP36	ubiquitin specific peptidase 36(USP36)	Homo sapiens	Parkinson Disease,
UCP2	uncoupling protein 2(UCP2)	Homo sapiens	Acquired Immunodeficiency Syndrome|Disease Progression,Acute Coronary Syndrome|Diabetes Complications|Diabetes mellitus|Obesity,Aging/ Telomere Length,Arthritis, Rheumatoid|Cholangitis, Sclerosing|Churg-Strauss Syndrome|Colitis, Ulcerative|Crohn Disease|Lupus Erythematosus, Systemic|Multiple Sclerosis|Psoriasis,Atherosclerosis|Diabetes Mellitus, Type 2,BMI   rosiglitazone or pioglitazone,Body Mass Index,Body Weight|Obesity|Overweight,Breast Neoplasms|Endometrial Neoplasms|Glucose Intolerance|Insulin Resistance,Bulimia,Cardiovascular Diseases|Cerebrovascular Disorders,Cardiovascular Diseases|Diabetes Mellitus, Type 2|Overweight,Cardiovascular Diseases|Inflammation,Chronic renal failure|Kidney Failure, Chronic,Coronary Disease,Coronary Disease|Diabetes Mellitus, Type 2|Diabetic Angiopathies,Diabetes Mellitus, Type 2,Diabetes Mellitus, Type 2|Myocardial Infarction,Diabetes mellitus type II|Diabetes Mellitus, Type 2,Diabetes mellitus type II|Diabetes Mellitus, Type 2|Diabetic Neuropathies,Diabetes mellitus type II|Diabetes Mellitus, Type 2|Glucose Metabolism Disorders,Diabetes mellitus type II|Diabetes Mellitus, Type 2|Insulin Resistance,Diabetes mellitus|Metabolic Syndrome X,Glomerulonephritis, IGA,Graves disease,Hypercholesterolemia|LDLC levels,Hyperglycemia|Insulin Resistance|Sepsis,Hyperhomocysteinemia|Venous Thrombosis,Kidney Failure, Chronic,Metabolic Syndrome,Metabolic Syndrome X|Obesity,Neural Tube Defects,Obesity,Obesity, Morbid,Obesity, Morbid|Weight Loss,Obesity|Overweight,Obesity|POF - Premature ovarian failure|POLYCYSTIC OVARIAN SYNDROME|Polycystic Ovary Syndrome|Primary Ovarian Insufficiency|Puberty, Delayed|Puberty, Precocious|Thrombophilia|Tobacco Use Disorder,Obesity|Weight Loss,Overfeeding,Sleep Apnea, Obstructive,Type 2 Diabetes| edema | rosiglitazone,Type 2 diabetes,Weight Loss,anorexia nervosa,atherosclerosis,atherosclerosis, coronary; diabetes, type 2,body mass,body mass insulin waist circumference,body mass; diabetes, type 2; energy expenditure,body mass; insulin; obesity; glucose,carotid atherosclerosis,cholesterol, HDL,cognitive trait,diabetes, type 2,diabetes, type 2; hypertension; obesity, localized,diabetes, type 2; obesity,elite endurance,exercise efficiency,fat reduction obesity,healthy oldest-old,heart disease, ischemic,insulin,insulin; lipids; obesity; glucose; blood pressure; hormones,insulin; obesity,leptin,metabolic syndrome,multiple sclerosis,neural tube defects,neuropathy, diabetic,normal variation,obesity,obesity|Type 2 diabetes,oxidative stress,oxidative stress ,peritoneal dialysis,plasma HDL cholesterol (HDL-C) levels,proliferative diabetic retinopathy,schizophrenia,weight gain,
UTRN	utrophin(UTRN)	Homo sapiens	Albumins,Hip,Hypertension,Iron,Leukocyte Count,Schizophrenia,Tobacco Use Disorder,
VPS13C	vacuolar protein sorting 13 homolog C(VPS13C)	Homo sapiens	Glucose Tolerance Test,Schizophrenia,two-hour glucose challenge ,
VPS4A	vacuolar protein sorting 4 homolog A(VPS4A)	Homo sapiens	Lipoproteins, HDL,
VAMP5	vesicle associated membrane protein 5(VAMP5)	Homo sapiens	glaucoma, primary open-angle,
VAMP7	vesicle associated membrane protein 7(VAMP7)	Homo sapiens	bipolar affective disorder,
VTA1	vesicle trafficking 1(VTA1)	Homo sapiens	Cardiovascular Diseases,Retinal Vein,Sleep,von Willebrand Factor,
VTI1B	vesicle transport through interaction with t-SNAREs 1B(VTI1B)	Homo sapiens	Alzheimer's disease   ,
VEZT	vezatin, adherens junctions transmembrane protein(VEZT)	Homo sapiens	Cholesterol,Cholesterol, LDL,Erythrocyte Indices,
VDAC1	voltage dependent anion channel 1(VDAC1)	Homo sapiens	Acquired Immunodeficiency Syndrome|Disease Progression,Multiple Sclerosis,Narcolepsy,
VHL	von Hippel-Lindau tumor suppressor(VHL)	Homo sapiens	Adrenal Gland Neoplasms|Adrenal Neoplasm|Neoplasms, Multiple Primary|Paraganglioma|Pheochromocytoma,Adrenal Gland Neoplasms|Adrenal Neoplasm|Paraganglioma|Pheochromocytoma,Adrenal Gland Neoplasms|Head and Neck Neoplasms|Paraganglioma|Pheochromocytoma,Adrenal Gland Neoplasms|Multiple Endocrine Neoplasia Type 2a|Paraganglioma|Pheochromocytoma|von Hippel-Lindau Disease,Adrenal Gland Neoplasms|Paraganglioma|Pheochromocytoma,Adrenal Gland Neoplasms|Pheochromocytoma,Altitude Sickness|,Carcinoma, Renal Cell|Kidney Neoplasms,Carcinoma, Renal Cell|Kidney Neoplasms|Renal Cell Carcinoma,Cerebellar Neoplasms|Hemangioblastoma|von Hippel-Lindau Disease,Chuvash-type congenital polycythemia,Head and Neck Neoplasms|Multiple Endocrine Neoplasia Type 2a|Paraganglioma|von Hippel-Lindau Disease,Head and Neck Neoplasms|Paraganglioma,Lymphoproliferative Disorders|Myelodysplastic Syndromes,Pancreatic Neoplasms,Polycythemia,Renal cell carcinoma,Type 2 Diabetes| edema | rosiglitazone,brain cancer,breast cancer,colorectal carcinoma,congenital polycythemia.,esophageal adenocarcinoma,germline mutations,kidney cancer,non-papillary renal cell carcinomas,pheochromocytoma,pheochromocytomas and paragangliomas,pheochtomocytomas,polycythemia,renal cancer,retinal hemangioblastomas,von Hippel-Lindau Disease,von Hippel-Lindau Disease|Von Hippel-Lindau Syndrome,von Hippel-Lindau syndrome (VHL).,von Hippel-Lindau type 2A,
ZFAND2A	zinc finger AN1-type containing 2A(ZFAND2A)	Homo sapiens	Cholesterol, HDL,Waist-Hip Ratio,
ZFAND3	zinc finger AN1-type containing 3(ZFAND3)	Homo sapiens	Alcoholism,Diabetes Mellitus, Type 2,Insulin Resistance,Tobacco Use Disorder,
ZMYM2	zinc finger MYM-type containing 2(ZMYM2)	Homo sapiens	Tobacco Use Disorder,
ZNF331	zinc finger protein 331(ZNF331)	Homo sapiens	Tobacco Use Disorder,
